30 100
AATATTTCCCCGATATGGATGCCAATCGAG|CAGTATTCGAGGAATCTCTTCTGGATGCCA
ACCCCTTCCTTTGACAATACCCCTTGGATG|AGGTTTGCGGACGTCGTCTAGAATTATGGG
GATGCCAATCGAGTCCTGGGAAGGATCCTC|CGAGTCCTGGGAAGGATCCTGGATGCCAAT
CGTTGGATGCCAATCGAGTCCTGGGAAGGA|GTTGCTCAGTGTTCCCTCTTCATGTCGGGT
CTGGCTTTCGCGAGCAATCCTCTAGTCCTT|TCCTCGTCCCAGTTCGATGAAGAAAGGTTC
ATCCCCATTATGAGGCGAATACGGGGGGAC|TTCGCGAGCAATCCTCTAGTCCTTACGCGA
AATCTCATGATTGACCCCTTCCTTTGACAA|CTGGAGCGATATTAGGTTTGCGGACGTCGT
GGATGCCAATCGAGTCCTGGGAAGGATCCC|TTGGATGCCAATCGAGTCCTGGTGGATGCC
TTGCGGACGTCGTCTAGAATTATGGGCCAG|GTAGTCGGGTCGGAGCTTGATCATGCCTAT
ACTATGTGATACTTGGATGCCAATCGAGTC|CCGTTGCCGCAGGCTTGGATGCCAATCGAG
TCCCTCTTCATGTCGGGTCCTGGACACCCA|TCAAGCTTGGAAGGCTTGCTCAAAGGCTTG
CCCCGGCCTACGACGAAAATTTAGGTAAGC|AGTCCTGGGAAGGATCCTCGGGCTACGAGC
TCCCCAATATGTGACGTGCGCAGTATTCGA|TGCCAATCGAGTCCTGGGAAGGATCCGTTG
TTAGGCGCGCTGGATGTGGATGCCAATCGA|GTCATAATGAATGGATGCCAATCGAGTCCT
CAACCGATTTGAGTTCGCAGTGATGGATGC|TGTCGATCAGGATATGGATGCCAATCGAGT
CCCGATATGGATGCCAATCGAGTCCTGGGA|GAGGAATCTCTTCTGGATGCCAATCGAGTC
CCATTATGAGGCGAATACGGGGGGACCGAA|CGAGCAATCCTCTAGTCCTTACGCGAGATG
CGGACGTCGTCTAGAATTATGGGCCAGTGT|GTCGGGTCGGAGCTTGATCATGCCTATTAG
TGAAGGGGCGCTCGATAGCCAATTTAACTT|GAATTCTATGCAGAGAGAATTTCAGCTGGC
CTAGAATTATGGGCCAGTGTCCGGGTACTG|AGCTTGATCATGCCTATTAGCACTTCATCC
GCGCGCTGGATGTGGATGCCAATCGAGTCC|TAATGAATGGATGCCAATCGAGTCCTGGGA
CGAGTCCTGGGAAGGATCCGTAATTCGCAT|GGATCCGGATGCCAATCGAGTCCTGGGAAG
CATTTAACGCTGTTACGAAGTAAGGCAAGA|AGGCGCGCTGGATGTGGATGCCAATCGAGT
GGTCATCCGAAATACCCTCGATTGTAGTCG|GGAAGGATCCGTGCTTTTAATTCGTTTGCC
GAGTCCTGGGAAGGATCCCCAATCGAGTCC|CTGGGAAGGATCCTAGAGCCGTCGCGTGCT
AGGAAATACAAACGTCGAGGGTCCCCGGCC|TCCTGGGAAGGATCCCCAATCGAGTCCTGG
CCCAGTTCGATGAAGAAAGGTTCGTAATAT|AAGGATCCCCAATATGTGACGTGCGCAGTA
TTTCGCGAGCAATCCTCTAGTCCTTACGCG|GTCCCAGTTCGATGAAGAAAGGTTCGTAAT
GGGTCCTGGACACCCAACCGATTTGAGTTC|CTTGCTCAAAGGCTTGTCGATCAGGATATG
TGGGTTGATCGAGTCGGTCCACTCGTTATA|ACTGCTGGATGCCAATCGAGTCCTGGGAAG
GAAGGATCCGTGCTTTTAATTCGTTTGCCA|TCCTGGGAAGGATCCGTAATTCGCATGCTC
TTGTCGATCAGGATATGGATGCCAATCGAG|ACGCTGTTACGAAGTAAGGCAAGAGGAAAT
GAGAGAATTTCAGCTGGCGTCCGGCTGGAG|TGGATCTTAGAAGTTATGGGTCATCCGAAA
GTCGAGGGTCCCCGGCCTACGACGAAAATT|CCCCAATCGAGTCCTGGGAAGGATCCTCGG
TGTGGATGCCAATCGAGTCCTGGGAAGGAT|ATGCCAATCGAGTCCTGGGAAGGATCCTAG
AGTTCGCAGTGATGGATGCCAATCGAGTCC|ATATGGATGCCAATCGAGTCCTGGGAAGGA
GGAAGGCTTGCTCAAAGGCTTGTCGATCAG|AATGGTCCCCCACCATTTAACGCTGTTACG
TTTGCGGACGTCGTCTAGAATTATGGGCCA|TGTAGTCGGGTCGGAGCTTGATCATGCCTA
ATACTTGGATGCCAATCGAGTCCTGGGAAG|GCAGGCTTGGATGCCAATCGAGTCCTGGTG
ATGCTTGTTGCTCAGTGTTCCCTCTTCATG|CTAGAAAGAGAATTGGTGTCAAGCTTGGAA
AATGGTCCCCCACCATTTAACGCTGTTACG|CTCCTAAAAACTTAGGCGCGCTGGATGTGG
GAGTTCGCAGTGATGGATGCCAATCGAGTC|GATATGGATGCCAATCGAGTCCTGGGAAGG
TCCACTCGTTATATCGCAATGGTCCCCCAC|GAGTCCTGGGAAGGATCCTCCTAAAAACTT
CTTGGATGCCAATCGAGTCCTGGGAAGGAT|ATTATGGGCCAGTGTCCGGGTACTGGCTTT
TAGGTAAGCCCACTGCTGGATGCCAATCGA|GCTACGAGCACTGAGGCTCACCACTGAGCA
TCGAGTCCTGGGAAGGATCCCCAATCGAGT|TCCTGGGAAGGATCCTAGAGCCGTCGCGTG
GAGGCGAATACGGGGGGACCGAATTCTATG|TCCTCTAGTCCTTACGCGAGATGAATATAT
AGGAATCTCTTCTGGATGCCAATCGAGTCC|GGATGCCAATCGAGTCCTGGGAAGGATCCG
TGATCATGCCTATTAGCACTTCATCCTCGT|GTGATACTTGGATGCCAATCGAGTCCTGGG
CTTGTCGATCAGGATATGGATGCCAATCGA|AACGCTGTTACGAAGTAAGGCAAGAGGAAA
GATGCCAATCGAGTCCTGGTGGATGCCAAT|CCGCCGAATCCATCGGCCGTGGCTCCGCTA
GGGAAGGATCCTCGGGCTACGAGCACTGAG|TGCGATGCCTTCTAGTTGCAGGCTTTCTAA
GCCAGGGGACTATGTGATACTTGGATGCCA|GCTCCGAGCCGTTGCCGCAGGCTTGGATGC
TACGCGAGATGAATATATTCTGGATCTTAG|CGTAATATTTCCCCGATATGGATGCCAATC
GGAGCTTGATCATGCCTATTAGCACTTCAT|GACTATGTGATACTTGGATGCCAATCGAGT
ACTCGTTATATCGCAATGGTCCCCCACCAT|TCCTGGGAAGGATCCTCCTAAAAACTTAGG
TAAGGCAAGAGGAAATACAAACGTCGAGGG|CCAATCGAGTCCTGGGAAGGATCCCCAATC
TGGATGCCAATCGAGTCCTGGGAAGGATCC|TGGCTCCGCTAAAGCAGCTCCGGATGCTTG
GGATGCCAATCGAGTCCTGGGAAGGATCCT|CCCGGCCTACGACGAAAATTTAGGTAAGCC
CTGGGAAGGATCCCCATTATGAGGCGAATA|GTACTGGCTTTCGCGAGCAATCCTCTAGTC
CGAGTCCTGGGAAGGATCCTCTGGGTTGAT|GACGAAAATTTAGGTAAGCCCACTGCTGGA
CCAGTGTCCGGGTACTGGCTTTCGCGAGCA|CTATTAGCACTTCATCCTCGTCCCAGTTCG
CGTTGCCGCAGGCTTGGATGCCAATCGAGT|ATCCCCTCAGCTGCTACCGCCGAATCCATC
CGAAGTAAGGCAAGAGGAAATACAAACGTC|GGATGCCAATCGAGTCCTGGGAAGGATCCC
TGGATGCCAATCGAGTCCTGGGAAGGATCC|AGTCCTGGGAAGGATCCGGATGCCAATCGA
TCGTAATATTTCCCCGATATGGATGCCAAT|TGCGCAGTATTCGAGGAATCTCTTCTGGAT
ACCCAACCGATTTGAGTTCGCAGTGATGGA|GCTTGTCGATCAGGATATGGATGCCAATCG
TCCTCTGGGTTGATCGAGTCGGTCCACTCG|AGCCCACTGCTGGATGCCAATCGAGTCCTG
TCGTCTAGAATTATGGGCCAGTGTCCGGGT|TCGGAGCTTGATCATGCCTATTAGCACTTC
AACGTCGAGGGTCCCCGGCCTACGACGAAA|GATCCCCAATCGAGTCCTGGGAAGGATCCT
TGCTCAAAGGCTTGTCGATCAGGATATGGA|CCCACCATTTAACGCTGTTACGAAGTAAGG
ATTCGCATGCTCCGAGCCGTTGCCGCAGGC|CTGGGAAGGATCCAAGGATCCCCTCAGCTG
TCTAGAAAGAGAATTGGTGTCAAGCTTGGA|ATCGAGTCGGTCCACTCGTTATATCGCAAT
GGACACCCAACCGATTTGAGTTCGCAGTGA|AAAGGCTTGTCGATCAGGATATGGATGCCA
GAGTCCTGGGAAGGATCCGTAATTCGCATG|GATCCGGATGCCAATCGAGTCCTGGGAAGG
ATATGTGACGTGCGCAGTATTCGAGGAATC|TCGAGTCCTGGGAAGGATCCGTTGGATGCC
TTGGATGCCAATCGAGTCCTGGGAAGGATC|TGCTCAGTGTTCCCTCTTCATGTCGGGTCC
CCGTGGCTCCGCTAAAGCAGCTCCGGATGC|AGCGGTCGCCCGTAATGGCTGACCTTCTAG
GTAGTCGGGTCGGAGCTTGATCATGCCTAT|GTTTGCCAGGGGACTATGTGATACTTGGAT
CCAATCGAGTCCTGGGAAGGATCCCCATTA|CCAGTGTCCGGGTACTGGCTTTCGCGAGCA
AGAATTATGGGCCAGTGTCCGGGTACTGGC|CTTGATCATGCCTATTAGCACTTCATCCTC
GTCCTGGGAAGGATCCGTTGGATGCCAATC|CAGCTCCGGATGCTTGTTGCTCAGTGTTCC
GCGAGCAATCCTCTAGTCCTTACGCGAGAT|CAGTTCGATGAAGAAAGGTTCGTAATATTT
ATACAAACGTCGAGGGTCCCCGGCCTACGA|GGAAGGATCCCCAATCGAGTCCTGGGAAGG
CATGATTGACCCCTTCCTTTGACAATACCC|GCGATATTAGGTTTGCGGACGTCGTCTAGA
CCGTGCTTTTAATTCGTTTGCCAGGGGACT|AAGGATCCGTAATTCGCATGCTCCGAGCCG
TTCGCAGTGATGGATGCCAATCGAGTCCTG|ATGGATGCCAATCGAGTCCTGGGAAGGATC
GGATGCCAATCGAGTCCTGGGAAGGATCCG|GGCTCCGCTAAAGCAGCTCCGGATGCTTGT
TGGGAAGGATCCTCCTAAAAACTTAGGCGC|TTTTCCGAGCACCCACCGAGTGGTCATAAT
AAGGATCCGTTGGATGCCAATCGAGTCCTG|GATGCTTGTTGCTCAGTGTTCCCTCTTCAT
GCTGGCGTCCGGCTGGAGCGATATTAGGTT|GTTATGGGTCATCCGAAATACCCTCGATTG
ATCGAGTCCTGGGAAGGATCCTCGGGCTAC|TCGCGTGCTCTGCGATGCCTTCTAGTTGCA
TTTAGGTAAGCCCACTGCTGGATGCCAATC|GGGCTACGAGCACTGAGGCTCACCACTGAG
CCCACTGCTGGATGCCAATCGAGTCCTGGG|CACTGAGGCTCACCACTGAGCAATCCTTTT
GCCTACGACGAAAATTTAGGTAAGCCCACT|TGGGAAGGATCCTCGGGCTACGAGCACTGA
GGGGGACCGAATTCTATGCAGAGAGAATTT|TACGCGAGATGAATATATTCTGGATCTTAG
TCCTGGGAAGGATCCGTAATTCGCATGCTC|CCGGATGCCAATCGAGTCCTGGGAAGGATC
CCCTTGGATGCCAATCGAGTCCTGGGAAGG|GAATTATGGGCCAGTGTCCGGGTACTGGCT
ATATTCTGGATCTTAGAAGTTATGGGTCAT|GATATGGATGCCAATCGAGTCCTGGGAAGG
CGAATCTCATGATTGACCCCTTCCTTTGAC|GGCTGGAGCGATATTAGGTTTGCGGACGTC
GATCCTCTGGGTTGATCGAGTCGGTCCACT|TAAGCCCACTGCTGGATGCCAATCGAGTCC
GCTCGATAGCCAATTTAACTTGACGCGAAT|GCAGAGAGAATTTCAGCTGGCGTCCGGCTG
ATGGATGCCAATCGAGTCCTGGGAAGGATC|TCTCTTCTGGATGCCAATCGAGTCCTGGGA
TCATGATTGACCCCTTCCTTTGACAATACC|AGCGATATTAGGTTTGCGGACGTCGTCTAG
GAATTCTATGCAGAGAGAATTTCAGCTGGC|ATGAATATATTCTGGATCTTAGAAGTTATG
GACCGAATTCTATGCAGAGAGAATTTCAGC|CGAGATGAATATATTCTGGATCTTAGAAGT
GTTCCCTCTTCATGTCGGGTCCTGGACACC|TGTCAAGCTTGGAAGGCTTGCTCAAAGGCT
CCCAACCGATTTGAGTTCGCAGTGATGGAT|CTTGTCGATCAGGATATGGATGCCAATCGA
TATATCGCAATGGTCCCCCACCATTTAACG|GAAGGATCCTCCTAAAAACTTAGGCGCGCT
TAAATGAAGGGGCGCTCGATAGCCAATTTA|GACCGAATTCTATGCAGAGAGAATTTCAGC
AGCTTGGAAGGCTTGCTCAAAGGCTTGTCG|ATCGCAATGGTCCCCCACCATTTAACGCTG
TCTATGCAGAGAGAATTTCAGCTGGCGTCC|ATATATTCTGGATCTTAGAAGTTATGGGTC
CTAAAGCAGCTCCGGATGCTTGTTGCTCAG|GTAATGGCTGACCTTCTAGAAAGAGAATTG
CCAATATGTGACGTGCGCAGTATTCGAGGA|CAATCGAGTCCTGGGAAGGATCCGTTGGAT
CCTGGACACCCAACCGATTTGAGTTCGCAG|CTCAAAGGCTTGTCGATCAGGATATGGATG
GAGTCCTGGGAAGGATCCTCCTAAAAACTT|CAATCCTTTTCCGAGCACCCACCGAGTGGT
GCTTTTAATTCGTTTGCCAGGGGACTATGT|ATCCGTAATTCGCATGCTCCGAGCCGTTGC
GATATGGATGCCAATCGAGTCCTGGGAAGG|GAATCTCTTCTGGATGCCAATCGAGTCCTG
TCCTGGGAAGGATCCTCTGGGTTGATCGAG|AAAATTTAGGTAAGCCCACTGCTGGATGCC
ACTGGCTTTCGCGAGCAATCCTCTAGTCCT|ATCCTCGTCCCAGTTCGATGAAGAAAGGTT
CCAATCGAGTCCTGGTGGATGCCAATCGAG|CGAATCCATCGGCCGTGGCTCCGCTAAAGC
ATGCCAATCGAGTCCTGGGAAGGATCCCCA|AATCGAGTCCTGGGAAGGATCCTAGAGCCG
GAATATATTCTGGATCTTAGAAGTTATGGG|CCCCGATATGGATGCCAATCGAGTCCTGGG
GATGAAGAAAGGTTCGTAATATTTCCCCGA|CCAATATGTGACGTGCGCAGTATTCGAGGA
TGGGAAGGATCCCCAATATGTGACGTGCGC|CCTGGTGGATGCCAATCGAGTCCTGGGAAG
ACGAAAATTTAGGTAAGCCCACTGCTGGAT|GATCCTCGGGCTACGAGCACTGAGGCTCAC
GCCAATCGAGTCCTGGGAAGGATCCTCCTA|CACTGAGCAATCCTTTTCCGAGCACCCACC
TTAACGCTGTTACGAAGTAAGGCAAGAGGA|CGCGCTGGATGTGGATGCCAATCGAGTCCT
CGGCCTACGACGAAAATTTAGGTAAGCCCA|CCTGGGAAGGATCCTCGGGCTACGAGCACT
TTAGAAGTTATGGGTCATCCGAAATACCCT|AATCGAGTCCTGGGAAGGATCCGTGCTTTT
TCATGTCGGGTCCTGGACACCCAACCGATT|TGGAAGGCTTGCTCAAAGGCTTGTCGATCA
TTGACAATACCCCTTGGATGCCAATCGAGT|ACGTCGTCTAGAATTATGGGCCAGTGTCCG
TGGGTCATCCGAAATACCCTCGATTGTAGT|TGGGAAGGATCCGTGCTTTTAATTCGTTTG
TTGGATGCCAATCGAGTCCTGGGAAGGATC|GCTTGGATGCCAATCGAGTCCTGGTGGATG
CTACCGCCGAATCCATCGGCCGTGGCTCCG|CCTGGGAAGGATCCTCCAGAGCGGTCGCCC
AACCGATTTGAGTTCGCAGTGATGGATGCC|GTCGATCAGGATATGGATGCCAATCGAGTC
TCTAGAATTATGGGCCAGTGTCCGGGTACT|GAGCTTGATCATGCCTATTAGCACTTCATC
ATCGAGTCCTGGGAAGGATCCTCTGGGTTG|ACGACGAAAATTTAGGTAAGCCCACTGCTG
CGCAGTGATGGATGCCAATCGAGTCCTGGG|GGATGCCAATCGAGTCCTGGGAAGGATCCT
ATTTCCCCGATATGGATGCCAATCGAGTCC|TATTCGAGGAATCTCTTCTGGATGCCAATC
CAGAGAGAATTTCAGCTGGCGTCCGGCTGG|TCTGGATCTTAGAAGTTATGGGTCATCCGA
ATCGAGTCCTGGGAAGGATCCTGGATGCCA|GGAAATACAAACGTCGAGGGTCCCCGGCCT
CATCGGCCGTGGCTCCGCTAAAGCAGCTCC|CTCCAGAGCGGTCGCCCGTAATGGCTGACC
GCTGTTACGAAGTAAGGCAAGAGGAAATAC|TGGATGTGGATGCCAATCGAGTCCTGGGAA
GGGTTGATCGAGTCGGTCCACTCGTTATAT|CTGCTGGATGCCAATCGAGTCCTGGGAAGG
GCAATGGTCCCCCACCATTTAACGCTGTTA|TCCTCCTAAAAACTTAGGCGCGCTGGATGT
TCCGCTAAAGCAGCTCCGGATGCTTGTTGC|GCCCGTAATGGCTGACCTTCTAGAAAGAGA
CCGCAGGCTTGGATGCCAATCGAGTCCTGG|CTCAGCTGCTACCGCCGAATCCATCGGCCG
ATTCGTTTGCCAGGGGACTATGTGATACTT|ATTCGCATGCTCCGAGCCGTTGCCGCAGGC
CACTTCATCCTCGTCCCAGTTCGATGAAGA|AATCGAGTCCTGGGAAGGATCCCCAATATG
CGAGTCCTGGGAAGGATCCTGGATGCCAAT|AAATACAAACGTCGAGGGTCCCCGGCCTAC
CTTGGATGCCAATCGAGTCCTGGGAAGGAT|GGCTTGGATGCCAATCGAGTCCTGGTGGAT
TTAACTTGACGCGAATCTCATGATTGACCC|AGCTGGCGTCCGGCTGGAGCGATATTAGGT
TATTAGCACTTCATCCTCGTCCCAGTTCGA|GATGCCAATCGAGTCCTGGGAAGGATCCCC
CAGTGATGGATGCCAATCGAGTCCTGGGAA|ATGCCAATCGAGTCCTGGGAAGGATCCTGG
AAAGGCTTGTCGATCAGGATATGGATGCCA|CATTTAACGCTGTTACGAAGTAAGGCAAGA
GAAGGGGCGCTCGATAGCCAATTTAACTTG|AATTCTATGCAGAGAGAATTTCAGCTGGCG
AAGGATCCCCATTATGAGGCGAATACGGGG|GGCTTTCGCGAGCAATCCTCTAGTCCTTAC
CTTGCTCAAAGGCTTGTCGATCAGGATATG|CCCCCACCATTTAACGCTGTTACGAAGTAA
GCCAATCGAGTCCTGGGAAGGATCCGGATG|GTGTTCCCTCTTCATGTCGGGTCCTGGACA
TAGCACTTCATCCTCGTCCCAGTTCGATGA|GCCAATCGAGTCCTGGGAAGGATCCCCAAT
ATCGAGTCCTGGGAAGGATCCCCATTATGA|GTGTCCGGGTACTGGCTTTCGCGAGCAATC
TTCGTTTGCCAGGGGACTATGTGATACTTG|TTCGCATGCTCCGAGCCGTTGCCGCAGGCT
TATGGGCCAGTGTCCGGGTACTGGCTTTCG|TCATGCCTATTAGCACTTCATCCTCGTCCC
TGTTGCTCAGTGTTCCCTCTTCATGTCGGG|AAGAGAATTGGTGTCAAGCTTGGAAGGCTT
TACCCTCGATTGTAGTCGGGTCGGAGCTTG|GCTTTTAATTCGTTTGCCAGGGGACTATGT
AATCGAGTCCTGGGAAGGATCCTCGGGCTA|GTCGCGTGCTCTGCGATGCCTTCTAGTTGC
TGTCGATCAGGATATGGATGCCAATCGAGT|CGCTGTTACGAAGTAAGGCAAGAGGAAATA
TCCTGGGAAGGATCCAAGGATCCCCTCAGC|TTTGAGTTCGCAGTGATGGATGCCAATCGA
TGGATGCCAATCGAGTCCTGGGAAGGATCC|CTCTTCTGGATGCCAATCGAGTCCTGGGAA
CTCTTCATGTCGGGTCCTGGACACCCAACC|AGCTTGGAAGGCTTGCTCAAAGGCTTGTCG
CTGGGAAGGATCCGTTGGATGCCAATCGAG|CTCCGGATGCTTGTTGCTCAGTGTTCCCTC
TCGGGTCGGAGCTTGATCATGCCTATTAGC|GCCAGGGGACTATGTGATACTTGGATGCCA
GGGAAGGATCCTCCTAAAAACTTAGGCGCG|TTTCCGAGCACCCACCGAGTGGTCATAATG
GGTTCGTAATATTTCCCCGATATGGATGCC|ACGTGCGCAGTATTCGAGGAATCTCTTCTG
CCTTCCTTTGACAATACCCCTTGGATGCCA|TTTGCGGACGTCGTCTAGAATTATGGGCCA
GCGAATCTCATGATTGACCCCTTCCTTTGA|CGGCTGGAGCGATATTAGGTTTGCGGACGT
CATTATGAGGCGAATACGGGGGGACCGAAT|GAGCAATCCTCTAGTCCTTACGCGAGATGA
CCTGGGAAGGATCCGTTGGATGCCAATCGA|GCTCCGGATGCTTGTTGCTCAGTGTTCCCT
TTTAATTCGTTTGCCAGGGGACTATGTGAT|CGTAATTCGCATGCTCCGAGCCGTTGCCGC
CGCGAGATGAATATATTCTGGATCTTAGAA|TAATATTTCCCCGATATGGATGCCAATCGA
TGGATGCCAATCGAGTCCTGGTGGATGCCA|TACCGCCGAATCCATCGGCCGTGGCTCCGC
AAGGTTCGTAATATTTCCCCGATATGGATG|TGACGTGCGCAGTATTCGAGGAATCTCTTC
GTCCTGGGAAGGATCCTCCTAAAAACTTAG|ATCCTTTTCCGAGCACCCACCGAGTGGTCA
AAATTTAGGTAAGCCCACTGCTGGATGCCA|CTCGGGCTACGAGCACTGAGGCTCACCACT
CAATCGAGTCCTGGGAAGGATCCTGGATGC|GAGGAAATACAAACGTCGAGGGTCCCCGGC
GGGAAGGATCCGTAATTCGCATGCTCCGAG|ATGCCAATCGAGTCCTGGGAAGGATCCAAG
AAGGATCCTCTGGGTTGATCGAGTCGGTCC|AGGTAAGCCCACTGCTGGATGCCAATCGAG
GCCAATCGAGTCCTGGGAAGGATCCGTTGG|CCGCTAAAGCAGCTCCGGATGCTTGTTGCT
TCTTCTGGATGCCAATCGAGTCCTGGGAAG|AATCGAGTCCTGGGAAGGATCCGGATGCCA
TTAGGTAAGCCCACTGCTGGATGCCAATCG|GGCTACGAGCACTGAGGCTCACCACTGAGC
GTCCTGGGAAGGATCCGTAATTCGCATGCT|TCCGGATGCCAATCGAGTCCTGGGAAGGAT
TCGTCCCAGTTCGATGAAGAAAGGTTCGTA|TGGGAAGGATCCCCAATATGTGACGTGCGC
TCAGCTGGCGTCCGGCTGGAGCGATATTAG|GAAGTTATGGGTCATCCGAAATACCCTCGA
CTCCGAGCCGTTGCCGCAGGCTTGGATGCC|ATCCAAGGATCCCCTCAGCTGCTACCGCCG
TGGGAAGGATCCTCCAGAGCGGTCGCCCGT|TCCTGGATGCCAATCGAGTCCTGGGAAGGA
AAGGATCCCCAATCGAGTCCTGGGAAGGAT|TCCTAGAGCCGTCGCGTGCTCTGCGATGCC
ATCGAGTCCTGGGAAGGATCCTCCAGAGCG|TGGGAAGGATCCTGGATGCCAATCGAGTCC
TGATTGACCCCTTCCTTTGACAATACCCCT|GATATTAGGTTTGCGGACGTCGTCTAGAAT
TAGTCCTTACGCGAGATGAATATATTCTGG|AAAGGTTCGTAATATTTCCCCGATATGGAT
CCTCGATTGTAGTCGGGTCGGAGCTTGATC|TTTAATTCGTTTGCCAGGGGACTATGTGAT
AATCGAGTCCTGGGAAGGATCCGTGCTTTT|GATGCCAATCGAGTCCTGGGAAGGATCCGT
CGGGTCCTGGACACCCAACCGATTTGAGTT|GCTTGCTCAAAGGCTTGTCGATCAGGATAT
CAATCCTCTAGTCCTTACGCGAGATGAATA|CGATGAAGAAAGGTTCGTAATATTTCCCCG
TGTAGTCGGGTCGGAGCTTGATCATGCCTA|CGTTTGCCAGGGGACTATGTGATACTTGGA
GTCCTGGGAAGGATCCTGGATGCCAATCGA|TACAAACGTCGAGGGTCCCCGGCCTACGAC
TCCGAAATACCCTCGATTGTAGTCGGGTCG|GATCCGTGCTTTTAATTCGTTTGCCAGGGG
TGGATGTGGATGCCAATCGAGTCCTGGGAA|ATGGATGCCAATCGAGTCCTGGGAAGGATC
GAGTCCTGGGAAGGATCCTCCAGAGCGGTC|GAAGGATCCTGGATGCCAATCGAGTCCTGG
GAAGTTATGGGTCATCCGAAATACCCTCGA|CGAGTCCTGGGAAGGATCCGTGCTTTTAAT
TCCTTACGCGAGATGAATATATTCTGGATC|GGTTCGTAATATTTCCCCGATATGGATGCC
GAAAGGTTCGTAATATTTCCCCGATATGGA|TGTGACGTGCGCAGTATTCGAGGAATCTCT
GGACGTCGTCTAGAATTATGGGCCAGTGTC|TCGGGTCGGAGCTTGATCATGCCTATTAGC
TCAAAGGCTTGTCGATCAGGATATGGATGC|ACCATTTAACGCTGTTACGAAGTAAGGCAA
TGGAAGGCTTGCTCAAAGGCTTGTCGATCA|CAATGGTCCCCCACCATTTAACGCTGTTAC
TACGGGGGGACCGAATTCTATGCAGAGAGA|TCCTTACGCGAGATGAATATATTCTGGATC
CGGATGCTTGTTGCTCAGTGTTCCCTCTTC|CTTCTAGAAAGAGAATTGGTGTCAAGCTTG
TCGAGTCCTGGGAAGGATCCGTTGGATGCC|AAAGCAGCTCCGGATGCTTGTTGCTCAGTG
CCGAAATACCCTCGATTGTAGTCGGGTCGG|ATCCGTGCTTTTAATTCGTTTGCCAGGGGA
TCGATGAAGAAAGGTTCGTAATATTTCCCC|CCCCAATATGTGACGTGCGCAGTATTCGAG
ATAGCCAATTTAACTTGACGCGAATCTCAT|GAGAATTTCAGCTGGCGTCCGGCTGGAGCG
GACGAAAATTTAGGTAAGCCCACTGCTGGA|GGATCCTCGGGCTACGAGCACTGAGGCTCA
TGGGAAGGATCCGTGCTTTTAATTCGTTTG|GAGTCCTGGGAAGGATCCGTAATTCGCATG
GAGTCCTGGGAAGGATCCTGGATGCCAATC|AATACAAACGTCGAGGGTCCCCGGCCTACG
ATGCCAATCGAGTCCTGGGAAGGATCCTCT|CGGCCTACGACGAAAATTTAGGTAAGCCCA
GCGAGATGAATATATTCTGGATCTTAGAAG|AATATTTCCCCGATATGGATGCCAATCGAG
AGTCCTGGGAAGGATCCGTTGGATGCCAAT|GCAGCTCCGGATGCTTGTTGCTCAGTGTTC
GGGAAGGATCCCCAATATGTGACGTGCGCA|CTGGTGGATGCCAATCGAGTCCTGGGAAGG
TGGCTGACCTTCTAGAAAGAGAATTGGTGT|CTCTGGGTTGATCGAGTCGGTCCACTCGTT
GAAATACCCTCGATTGTAGTCGGGTCGGAG|CCGTGCTTTTAATTCGTTTGCCAGGGGACT
CATGCCTATTAGCACTTCATCCTCGTCCCA|TACTTGGATGCCAATCGAGTCCTGGGAAGG
CAATCGAGTCCTGGGAAGGATCCCCATTAT|CAGTGTCCGGGTACTGGCTTTCGCGAGCAA
GAAGGATCCCCAATATGTGACGTGCGCAGT|GGTGGATGCCAATCGAGTCCTGGGAAGGAT
GGATGCCAATCGAGTCCTGGGAAGGATCCT|AGGCAAGAGGAAATACAAACGTCGAGGGTC
GACCTTCTAGAAAGAGAATTGGTGTCAAGC|GGTTGATCGAGTCGGTCCACTCGTTATATC
GGCTACGAGCACTGAGGCTCACCACTGAGC|GTTGCAGGCTTTCTAAGCGTTGAATACCGG
TGGATGCCAATCGAGTCCTGGGAAGGATCC|CTCACCACTGAGCAATCCTTTTCCGAGCAC
ATGTGATACTTGGATGCCAATCGAGTCCTG|TTGCCGCAGGCTTGGATGCCAATCGAGTCC
CAGTGTCCGGGTACTGGCTTTCGCGAGCAA|TATTAGCACTTCATCCTCGTCCCAGTTCGA
GAATTTCAGCTGGCGTCCGGCTGGAGCGAT|TCTTAGAAGTTATGGGTCATCCGAAATACC
TCATGCCTATTAGCACTTCATCCTCGTCCC|ATACTTGGATGCCAATCGAGTCCTGGGAAG
ATCCTCGTCCCAGTTCGATGAAGAAAGGTT|GTCCTGGGAAGGATCCCCAATATGTGACGT
GGTTGATCGAGTCGGTCCACTCGTTATATC|TGCTGGATGCCAATCGAGTCCTGGGAAGGA
ATGAATATATTCTGGATCTTAGAAGTTATG|TTCCCCGATATGGATGCCAATCGAGTCCTG
GTCCTGGGAAGGATCCGTGCTTTTAATTCG|AATCGAGTCCTGGGAAGGATCCGTAATTCG
AATCGAGTCCTGGGAAGGATCCAAGGATCC|CAACCGATTTGAGTTCGCAGTGATGGATGC
ATCGAGTCCTGGGAAGGATCCCCAATCGAG|GTCCTGGGAAGGATCCTAGAGCCGTCGCGT
GGCTTGCTCAAAGGCTTGTCGATCAGGATA|GTCCCCCACCATTTAACGCTGTTACGAAGT
TATGGGTCATCCGAAATACCCTCGATTGTA|CCTGGGAAGGATCCGTGCTTTTAATTCGTT
TTGCTCAGTGTTCCCTCTTCATGTCGGGTC|GAGAATTGGTGTCAAGCTTGGAAGGCTTGC
CCTCCTAAAAACTTAGGCGCGCTGGATGTG|ACCCACCGAGTGGTCATAATGAATGGATGC
CAAGGATCCCCTCAGCTGCTACCGCCGAAT|GATGGATGCCAATCGAGTCCTGGGAAGGAT
CCAATCGAGTCCTGGGAAGGATCCTCCAGA|TCCTGGGAAGGATCCTGGATGCCAATCGAG
TCGAGTCCTGGGAAGGATCCTCCTAAAAAC|AGCAATCCTTTTCCGAGCACCCACCGAGTG
TATTCTGGATCTTAGAAGTTATGGGTCATC|ATATGGATGCCAATCGAGTCCTGGGAAGGA
CCACTCGTTATATCGCAATGGTCCCCCACC|AGTCCTGGGAAGGATCCTCCTAAAAACTTA
ACCGAATTCTATGCAGAGAGAATTTCAGCT|GAGATGAATATATTCTGGATCTTAGAAGTT
TCTCTTCTGGATGCCAATCGAGTCCTGGGA|CCAATCGAGTCCTGGGAAGGATCCGGATGC
CTGTTACGAAGTAAGGCAAGAGGAAATACA|GGATGTGGATGCCAATCGAGTCCTGGGAAG
AATCGAGTCCTGGGAAGGATCCGTAATTCG|GAAGGATCCGGATGCCAATCGAGTCCTGGG
CCAATCGAGTCCTGGGAAGGATCCCCAATC|CGAGTCCTGGGAAGGATCCTAGAGCCGTCG
TTTAACTTGACGCGAATCTCATGATTGACC|CAGCTGGCGTCCGGCTGGAGCGATATTAGG
TCGCGAGCAATCCTCTAGTCCTTACGCGAG|CCCAGTTCGATGAAGAAAGGTTCGTAATAT
TGGATGCCAATCGAGTCCTGGGAAGGATCC|GCCAATCGAGTCCTGGGAAGGATCCTAGAG
ACCGATTTGAGTTCGCAGTGATGGATGCCA|TCGATCAGGATATGGATGCCAATCGAGTCC
TGCCGCAGGCTTGGATGCCAATCGAGTCCT|CCCTCAGCTGCTACCGCCGAATCCATCGGC
CGTAATATTTCCCCGATATGGATGCCAATC|GCGCAGTATTCGAGGAATCTCTTCTGGATG
ATATTTCCCCGATATGGATGCCAATCGAGT|AGTATTCGAGGAATCTCTTCTGGATGCCAA
ACGTCGAGGGTCCCCGGCCTACGACGAAAA|ATCCCCAATCGAGTCCTGGGAAGGATCCTC
AGGATCCGTAATTCGCATGCTCCGAGCCGT|CAATCGAGTCCTGGGAAGGATCCAAGGATC
GGATGCCAATCGAGTCCTGGGAAGGATCCG|CTCAGTGTTCCCTCTTCATGTCGGGTCCTG
CATCCGAAATACCCTCGATTGTAGTCGGGT|AGGATCCGTGCTTTTAATTCGTTTGCCAGG
TATTCGAGGAATCTCTTCTGGATGCCAATC|TCCGTTGGATGCCAATCGAGTCCTGGGAAG
TGGGAAGGATCCAAGGATCCCCTCAGCTGC|GAGTTCGCAGTGATGGATGCCAATCGAGTC
CTCTGGGTTGATCGAGTCGGTCCACTCGTT|CCCACTGCTGGATGCCAATCGAGTCCTGGG
CCGTAAATGAAGGGGCGCTCGATAGCCAAT|GGGGACCGAATTCTATGCAGAGAGAATTTC
GGCGTCCGGCTGGAGCGATATTAGGTTTGC|ATGGGTCATCCGAAATACCCTCGATTGTAG
GGGAAGGATCCCCATTATGAGGCGAATACG|ACTGGCTTTCGCGAGCAATCCTCTAGTCCT
AATTATGGGCCAGTGTCCGGGTACTGGCTT|TGATCATGCCTATTAGCACTTCATCCTCGT
GCCGAATCCATCGGCCGTGGCTCCGCTAAA|GAAGGATCCTCCAGAGCGGTCGCCCGTAAT
ACCATTTAACGCTGTTACGAAGTAAGGCAA|TTAGGCGCGCTGGATGTGGATGCCAATCGA
CACCGTAAATGAAGGGGCGCTCGATAGCCA|GGGGGGACCGAATTCTATGCAGAGAGAATT
GTAAGGCAAGAGGAAATACAAACGTCGAGG|GCCAATCGAGTCCTGGGAAGGATCCCCAAT
TCCCAGTTCGATGAAGAAAGGTTCGTAATA|GAAGGATCCCCAATATGTGACGTGCGCAGT
ACGCGAGATGAATATATTCTGGATCTTAGA|GTAATATTTCCCCGATATGGATGCCAATCG
GTCCTGGGAAGGATCCGGATGCCAATCGAG|CTTCATGTCGGGTCCTGGACACCCAACCGA
ATCCTCCTAAAAACTTAGGCGCGCTGGATG|GCACCCACCGAGTGGTCATAATGAATGGAT
CGAGTCCTGGGAAGGATCCTCCTAAAAACT|GCAATCCTTTTCCGAGCACCCACCGAGTGG
GGATCCCCAATATGTGACGTGCGCAGTATT|GGATGCCAATCGAGTCCTGGGAAGGATCCG
CGTCTAGAATTATGGGCCAGTGTCCGGGTA|CGGAGCTTGATCATGCCTATTAGCACTTCA
GATGCCAATCGAGTCCTGGGAAGGATCCGG|TCAGTGTTCCCTCTTCATGTCGGGTCCTGG
CCGCCGAATCCATCGGCCGTGGCTCCGCTA|GGGAAGGATCCTCCAGAGCGGTCGCCCGTA
GATGCCAATCGAGTCCTGGGAAGGATCCAA|GACACCCAACCGATTTGAGTTCGCAGTGAT
AAGGATCCTCGGGCTACGAGCACTGAGGCT|GATGCCTTCTAGTTGCAGGCTTTCTAAGCG
CCATCGGCCGTGGCTCCGCTAAAGCAGCTC|CCTCCAGAGCGGTCGCCCGTAATGGCTGAC
CGACGAAAATTTAGGTAAGCCCACTGCTGG|AGGATCCTCGGGCTACGAGCACTGAGGCTC
TGGGAAGGATCCGGATGCCAATCGAGTCCT|ATGTCGGGTCCTGGACACCCAACCGATTTG
TCAGGATATGGATGCCAATCGAGTCCTGGG|TACGAAGTAAGGCAAGAGGAAATACAAACG
CTGGATGTGGATGCCAATCGAGTCCTGGGA|AATGGATGCCAATCGAGTCCTGGGAAGGAT
TGCCAATCGAGTCCTGGGAAGGATCCGGAT|AGTGTTCCCTCTTCATGTCGGGTCCTGGAC
CGAGTCCTGGGAAGGATCCGGATGCCAATC|CCTCTTCATGTCGGGTCCTGGACACCCAAC
TGTTCCCTCTTCATGTCGGGTCCTGGACAC|GTGTCAAGCTTGGAAGGCTTGCTCAAAGGC
ATTTAACTTGACGCGAATCTCATGATTGAC|TCAGCTGGCGTCCGGCTGGAGCGATATTAG
AGTTCGATGAAGAAAGGTTCGTAATATTTC|GATCCCCAATATGTGACGTGCGCAGTATTC
TCCGGCTGGAGCGATATTAGGTTTGCGGAC|GTCATCCGAAATACCCTCGATTGTAGTCGG
ATCATGCCTATTAGCACTTCATCCTCGTCC|GATACTTGGATGCCAATCGAGTCCTGGGAA
GGAGCGATATTAGGTTTGCGGACGTCGTCT|GAAATACCCTCGATTGTAGTCGGGTCGGAG
TGGCTTTCGCGAGCAATCCTCTAGTCCTTA|CCTCGTCCCAGTTCGATGAAGAAAGGTTCG
CTTGTTGCTCAGTGTTCCCTCTTCATGTCG|GAAAGAGAATTGGTGTCAAGCTTGGAAGGC
CAATCGAGTCCTGGGAAGGATCCTCGGGCT|CGTCGCGTGCTCTGCGATGCCTTCTAGTTG
AAAAACTTAGGCGCGCTGGATGTGGATGCC|CGAGTGGTCATAATGAATGGATGCCAATCG
AGAATTGGTGTCAAGCTTGGAAGGCTTGCT|GTCCACTCGTTATATCGCAATGGTCCCCCA
CTAGTCCTTACGCGAGATGAATATATTCTG|GAAAGGTTCGTAATATTTCCCCGATATGGA
TTTCCCCGATATGGATGCCAATCGAGTCCT|ATTCGAGGAATCTCTTCTGGATGCCAATCG
GCTACGAGCACTGAGGCTCACCACTGAGCA|TTGCAGGCTTTCTAAGCGTTGAATACCGGA
GAGTCCTGGGAAGGATCCGGATGCCAATCG|CTCTTCATGTCGGGTCCTGGACACCCAACC
TTCCCTCTTCATGTCGGGTCCTGGACACCC|GTCAAGCTTGGAAGGCTTGCTCAAAGGCTT
CTTTTAATTCGTTTGCCAGGGGACTATGTG|TCCGTAATTCGCATGCTCCGAGCCGTTGCC
CGAAATACCCTCGATTGTAGTCGGGTCGGA|TCCGTGCTTTTAATTCGTTTGCCAGGGGAC
GCTGGATGTGGATGCCAATCGAGTCCTGGG|GAATGGATGCCAATCGAGTCCTGGGAAGGA
GAATACGGGGGGACCGAATTCTATGCAGAG|TAGTCCTTACGCGAGATGAATATATTCTGG
TCTTAGAAGTTATGGGTCATCCGAAATACC|CCAATCGAGTCCTGGGAAGGATCCGTGCTT
TTGACGCGAATCTCATGATTGACCCCTTCC|GCGTCCGGCTGGAGCGATATTAGGTTTGCG
TTTAACGCTGTTACGAAGTAAGGCAAGAGG|GCGCGCTGGATGTGGATGCCAATCGAGTCC
TGAATATATTCTGGATCTTAGAAGTTATGG|TCCCCGATATGGATGCCAATCGAGTCCTGG
TGCCTATTAGCACTTCATCCTCGTCCCAGT|CTTGGATGCCAATCGAGTCCTGGGAAGGAT
GTTCGCAGTGATGGATGCCAATCGAGTCCT|TATGGATGCCAATCGAGTCCTGGGAAGGAT
TGACCCCTTCCTTTGACAATACCCCTTGGA|TTAGGTTTGCGGACGTCGTCTAGAATTATG
TCAGCTGCTACCGCCGAATCCATCGGCCGT|ATCGAGTCCTGGGAAGGATCCTCCAGAGCG
ATGGATGCCAATCGAGTCCTGGGAAGGATC|AATCGAGTCCTGGGAAGGATCCTGGATGCC
GCGCAGTATTCGAGGAATCTCTTCTGGATG|GAAGGATCCGTTGGATGCCAATCGAGTCCT
GGCGCGCTGGATGTGGATGCCAATCGAGTC|ATAATGAATGGATGCCAATCGAGTCCTGGG
TTCGCGAGCAATCCTCTAGTCCTTACGCGA|TCCCAGTTCGATGAAGAAAGGTTCGTAATA
GCCAATCGAGTCCTGGGAAGGATCCTGGAT|AAGAGGAAATACAAACGTCGAGGGTCCCCG
TGCCAATCGAGTCCTGGGAAGGATCCGTGC|TCTGGATGCCAATCGAGTCCTGGGAAGGAT
TCCCCCACCATTTAACGCTGTTACGAAGTA|AAAAACTTAGGCGCGCTGGATGTGGATGCC
TGACGCGAATCTCATGATTGACCCCTTCCT|CGTCCGGCTGGAGCGATATTAGGTTTGCGG
TGCTGGATGCCAATCGAGTCCTGGGAAGGA|AGGCTCACCACTGAGCAATCCTTTTCCGAG
CGGGCTACGAGCACTGAGGCTCACCACTGA|TAGTTGCAGGCTTTCTAAGCGTTGAATACC
AAATACCCTCGATTGTAGTCGGGTCGGAGC|CGTGCTTTTAATTCGTTTGCCAGGGGACTA
GGCTCCGCTAAAGCAGCTCCGGATGCTTGT|GTCGCCCGTAATGGCTGACCTTCTAGAAAG
AGTCCTGGGAAGGATCCCCAATATGTGACG|CGAGTCCTGGTGGATGCCAATCGAGTCCTG
GCCAATCGAGTCCTGGGAAGGATCCCCAAT|TCGAGTCCTGGGAAGGATCCTAGAGCCGTC
CCTGGGAAGGATCCTCCAGAGCGGTCGCCC|GATCCTGGATGCCAATCGAGTCCTGGGAAG
ACAATACCCCTTGGATGCCAATCGAGTCCT|TCGTCTAGAATTATGGGCCAGTGTCCGGGT
CCCTCGATTGTAGTCGGGTCGGAGCTTGAT|TTTTAATTCGTTTGCCAGGGGACTATGTGA
GTCCTGGGAAGGATCCTCTGGGTTGATCGA|GAAAATTTAGGTAAGCCCACTGCTGGATGC
GATGCCAATCGAGTCCTGGGAAGGATCCCC|TGGATGCCAATCGAGTCCTGGTGGATGCCA
TCGGTCCACTCGTTATATCGCAATGGTCCC|AATCGAGTCCTGGGAAGGATCCTCCTAAAA
AGGCTTGTCGATCAGGATATGGATGCCAAT|TTTAACGCTGTTACGAAGTAAGGCAAGAGG
TCGATCAGGATATGGATGCCAATCGAGTCC|CTGTTACGAAGTAAGGCAAGAGGAAATACA
TGGTGTCAAGCTTGGAAGGCTTGCTCAAAG|CTCGTTATATCGCAATGGTCCCCCACCATT
TAATTCGCATGCTCCGAGCCGTTGCCGCAG|TCCTGGGAAGGATCCAAGGATCCCCTCAGC
GCAGTATTCGAGGAATCTCTTCTGGATGCC|AGGATCCGTTGGATGCCAATCGAGTCCTGG
ACTTAGGCGCGCTGGATGTGGATGCCAATC|TGGTCATAATGAATGGATGCCAATCGAGTC
GACGTCGTCTAGAATTATGGGCCAGTGTCC|CGGGTCGGAGCTTGATCATGCCTATTAGCA
GGATCCGGATGCCAATCGAGTCCTGGGAAG|GGTCCTGGACACCCAACCGATTTGAGTTCG
ATGGATGCCAATCGAGTCCTGGGAAGGATC|TAAGGCAAGAGGAAATACAAACGTCGAGGG
GTATTCGAGGAATCTCTTCTGGATGCCAAT|ATCCGTTGGATGCCAATCGAGTCCTGGGAA
TGCCAATCGAGTCCTGGGAAGGATCCGTTG|TCCGCTAAAGCAGCTCCGGATGCTTGTTGC
TGGATGCCAATCGAGTCCTGGGAAGGATCC|CTTGGATGCCAATCGAGTCCTGGTGGATGC
GCTCAGTGTTCCCTCTTCATGTCGGGTCCT|GAATTGGTGTCAAGCTTGGAAGGCTTGCTC
CCGTTGCCGCAGGCTTGGATGCCAATCGAG|GATCCCCTCAGCTGCTACCGCCGAATCCAT
TCTGGATCTTAGAAGTTATGGGTCATCCGA|TGGATGCCAATCGAGTCCTGGGAAGGATCC
TTCGTAATATTTCCCCGATATGGATGCCAA|GTGCGCAGTATTCGAGGAATCTCTTCTGGA
CGAGTCCTGGGAAGGATCCCCAATATGTGA|ATCGAGTCCTGGTGGATGCCAATCGAGTCC
ACTGCTGGATGCCAATCGAGTCCTGGGAAG|TGAGGCTCACCACTGAGCAATCCTTTTCCG
CCACTGCTGGATGCCAATCGAGTCCTGGGA|ACTGAGGCTCACCACTGAGCAATCCTTTTC
GTCCACTCGTTATATCGCAATGGTCCCCCA|CGAGTCCTGGGAAGGATCCTCCTAAAAACT
TGCTTGTTGCTCAGTGTTCCCTCTTCATGT|TAGAAAGAGAATTGGTGTCAAGCTTGGAAG
CGGATGCCAATCGAGTCCTGGGAAGGATCC|TGGACACCCAACCGATTTGAGTTCGCAGTG
GGATGCCAATCGAGTCCTGGGAAGGATCCC|ATGGGCCAGTGTCCGGGTACTGGCTTTCGC
TGTCAAGCTTGGAAGGCTTGCTCAAAGGCT|GTTATATCGCAATGGTCCCCCACCATTTAA
ATCTCTTCTGGATGCCAATCGAGTCCTGGG|GCCAATCGAGTCCTGGGAAGGATCCGGATG
TATATTCTGGATCTTAGAAGTTATGGGTCA|CGATATGGATGCCAATCGAGTCCTGGGAAG
AAAATTTAGGTAAGCCCACTGCTGGATGCC|CCTCGGGCTACGAGCACTGAGGCTCACCAC
CTCCGGATGCTTGTTGCTCAGTGTTCCCTC|GACCTTCTAGAAAGAGAATTGGTGTCAAGC
AAAGAGAATTGGTGTCAAGCTTGGAAGGCT|GTCGGTCCACTCGTTATATCGCAATGGTCC
CCTGGGAAGGATCCGTAATTCGCATGCTCC|CGGATGCCAATCGAGTCCTGGGAAGGATCC
GAGATGAATATATTCTGGATCTTAGAAGTT|TATTTCCCCGATATGGATGCCAATCGAGTC
AAGAAAGGTTCGTAATATTTCCCCGATATG|TATGTGACGTGCGCAGTATTCGAGGAATCT
GGCTGACCTTCTAGAAAGAGAATTGGTGTC|TCTGGGTTGATCGAGTCGGTCCACTCGTTA
GTGGCTCCGCTAAAGCAGCTCCGGATGCTT|CGGTCGCCCGTAATGGCTGACCTTCTAGAA
TGTCGGGTCCTGGACACCCAACCGATTTGA|AAGGCTTGCTCAAAGGCTTGTCGATCAGGA
GTTATATCGCAATGGTCCCCCACCATTTAA|GGGAAGGATCCTCCTAAAAACTTAGGCGCG
CCGGATGCTTGTTGCTCAGTGTTCCCTCTT|CCTTCTAGAAAGAGAATTGGTGTCAAGCTT
CTCCTAAAAACTTAGGCGCGCTGGATGTGG|CCCACCGAGTGGTCATAATGAATGGATGCC
AAGGATCCAAGGATCCCCTCAGCTGCTACC|TCGCAGTGATGGATGCCAATCGAGTCCTGG
ACCCTCGATTGTAGTCGGGTCGGAGCTTGA|CTTTTAATTCGTTTGCCAGGGGACTATGTG
TGCCAATCGAGTCCTGGGAAGGATCCCCAA|GATGCCAATCGAGTCCTGGTGGATGCCAAT
GAAGGATCCGTTGGATGCCAATCGAGTCCT|GGATGCTTGTTGCTCAGTGTTCCCTCTTCA
GTCCTGGGAAGGATCCCCAATATGTGACGT|GAGTCCTGGTGGATGCCAATCGAGTCCTGG
GAAGGATCCTGGATGCCAATCGAGTCCTGG|GTCGAGGGTCCCCGGCCTACGACGAAAATT
CTCAAAGGCTTGTCGATCAGGATATGGATG|CACCATTTAACGCTGTTACGAAGTAAGGCA
AGGATCCTCCAGAGCGGTCGCCCGTAATGG|GATGCCAATCGAGTCCTGGGAAGGATCCTC
CCTCAGCTGCTACCGCCGAATCCATCGGCC|CAATCGAGTCCTGGGAAGGATCCTCCAGAG
TGGGCCAGTGTCCGGGTACTGGCTTTCGCG|ATGCCTATTAGCACTTCATCCTCGTCCCAG
GGTCCCCCACCATTTAACGCTGTTACGAAG|CTAAAAACTTAGGCGCGCTGGATGTGGATG
CTCATGATTGACCCCTTCCTTTGACAATAC|GAGCGATATTAGGTTTGCGGACGTCGTCTA
GTAAGCCCACTGCTGGATGCCAATCGAGTC|ACGAGCACTGAGGCTCACCACTGAGCAATC
GTAATATTTCCCCGATATGGATGCCAATCG|CGCAGTATTCGAGGAATCTCTTCTGGATGC
CGTCCCAGTTCGATGAAGAAAGGTTCGTAA|GGGAAGGATCCCCAATATGTGACGTGCGCA
TGATCGAGTCGGTCCACTCGTTATATCGCA|TGGATGCCAATCGAGTCCTGGGAAGGATCC
ATCCGAAATACCCTCGATTGTAGTCGGGTC|GGATCCGTGCTTTTAATTCGTTTGCCAGGG
TCCTGGGAAGGATCCTGGATGCCAATCGAG|ACAAACGTCGAGGGTCCCCGGCCTACGACG
TCGCAGTGATGGATGCCAATCGAGTCCTGG|TGGATGCCAATCGAGTCCTGGGAAGGATCC
ATCGAGTCCTGGTGGATGCCAATCGAGTCC|ATCCATCGGCCGTGGCTCCGCTAAAGCAGC
CTCAGCTGCTACCGCCGAATCCATCGGCCG|AATCGAGTCCTGGGAAGGATCCTCCAGAGC
CTCTTCTGGATGCCAATCGAGTCCTGGGAA|CAATCGAGTCCTGGGAAGGATCCGGATGCC
AATCGAGTCCTGGGAAGGATCCGGATGCCA|TTCCCTCTTCATGTCGGGTCCTGGACACCC
AAGGATCCTCCTAAAAACTTAGGCGCGCTG|CCGAGCACCCACCGAGTGGTCATAATGAAT
AATACCCCTTGGATGCCAATCGAGTCCTGG|GTCTAGAATTATGGGCCAGTGTCCGGGTAC
AGAGGAAATACAAACGTCGAGGGTCCCCGG|AGTCCTGGGAAGGATCCCCAATCGAGTCCT
ACAAACGTCGAGGGTCCCCGGCCTACGACG|AAGGATCCCCAATCGAGTCCTGGGAAGGAT
TTCTATGCAGAGAGAATTTCAGCTGGCGTC|AATATATTCTGGATCTTAGAAGTTATGGGT
CCTCTTCATGTCGGGTCCTGGACACCCAAC|AAGCTTGGAAGGCTTGCTCAAAGGCTTGTC
AGGATCCAAGGATCCCCTCAGCTGCTACCG|CGCAGTGATGGATGCCAATCGAGTCCTGGG
AGGCAAGAGGAAATACAAACGTCGAGGGTC|AATCGAGTCCTGGGAAGGATCCCCAATCGA
AGTCCTGGGAAGGATCCGGATGCCAATCGA|TCTTCATGTCGGGTCCTGGACACCCAACCG
GGATCCCCAATCGAGTCCTGGGAAGGATCC|CTAGAGCCGTCGCGTGCTCTGCGATGCCTT
GGATGCCAATCGAGTCCTGGGAAGGATCCT|TCACCACTGAGCAATCCTTTTCCGAGCACC
AAGCAGCTCCGGATGCTTGTTGCTCAGTGT|ATGGCTGACCTTCTAGAAAGAGAATTGGTG
CGATCAGGATATGGATGCCAATCGAGTCCT|TGTTACGAAGTAAGGCAAGAGGAAATACAA
ATGCTCCGAGCCGTTGCCGCAGGCTTGGAT|AGGATCCAAGGATCCCCTCAGCTGCTACCG
GGGAAGGATCCTGGATGCCAATCGAGTCCT|ACGTCGAGGGTCCCCGGCCTACGACGAAAA
GCGGACGTCGTCTAGAATTATGGGCCAGTG|AGTCGGGTCGGAGCTTGATCATGCCTATTA
CGAGTCCTGGTGGATGCCAATCGAGTCCTG|CCATCGGCCGTGGCTCCGCTAAAGCAGCTC
TAAAGCAGCTCCGGATGCTTGTTGCTCAGT|TAATGGCTGACCTTCTAGAAAGAGAATTGG
ATCGAGTCCTGGGAAGGATCCTCCTAAAAA|GAGCAATCCTTTTCCGAGCACCCACCGAGT
AGTCGGTCCACTCGTTATATCGCAATGGTC|CCAATCGAGTCCTGGGAAGGATCCTCCTAA
GTGATGGATGCCAATCGAGTCCTGGGAAGG|GCCAATCGAGTCCTGGGAAGGATCCTGGAT
GCCCGTAATGGCTGACCTTCTAGAAAGAGA|GAAGGATCCTCTGGGTTGATCGAGTCGGTC
CAATACCCCTTGGATGCCAATCGAGTCCTG|CGTCTAGAATTATGGGCCAGTGTCCGGGTA
TATGCAGAGAGAATTTCAGCTGGCGTCCGG|ATATTCTGGATCTTAGAAGTTATGGGTCAT
CCTTGGATGCCAATCGAGTCCTGGGAAGGA|AATTATGGGCCAGTGTCCGGGTACTGGCTT
ATGCCTATTAGCACTTCATCCTCGTCCCAG|ACTTGGATGCCAATCGAGTCCTGGGAAGGA
GCTTGTCGATCAGGATATGGATGCCAATCG|TAACGCTGTTACGAAGTAAGGCAAGAGGAA
CCGGGTACTGGCTTTCGCGAGCAATCCTCT|CACTTCATCCTCGTCCCAGTTCGATGAAGA
CCGAATCCATCGGCCGTGGCTCCGCTAAAG|AAGGATCCTCCAGAGCGGTCGCCCGTAATG
ATGCAGAGAGAATTTCAGCTGGCGTCCGGC|TATTCTGGATCTTAGAAGTTATGGGTCATC
GGTCCCCGGCCTACGACGAAAATTTAGGTA|TCGAGTCCTGGGAAGGATCCTCGGGCTACG
AGGATCCCCAATCGAGTCCTGGGAAGGATC|CCTAGAGCCGTCGCGTGCTCTGCGATGCCT
CGTCGTCTAGAATTATGGGCCAGTGTCCGG|GGTCGGAGCTTGATCATGCCTATTAGCACT
CTGGGAAGGATCCCCAATATGTGACGTGCG|TCCTGGTGGATGCCAATCGAGTCCTGGGAA
ATCCGGATGCCAATCGAGTCCTGGGAAGGA|TCCTGGACACCCAACCGATTTGAGTTCGCA
CTTACGCGAGATGAATATATTCTGGATCTT|TTCGTAATATTTCCCCGATATGGATGCCAA
GAAGGATCCCCAATCGAGTCCTGGGAAGGA|ATCCTAGAGCCGTCGCGTGCTCTGCGATGC
GGATGCCAATCGAGTCCTGGGAAGGATCCG|GTCCTGGGAAGGATCCGGATGCCAATCGAG
AGTCCTTACGCGAGATGAATATATTCTGGA|AAGGTTCGTAATATTTCCCCGATATGGATG
CCAGGGGACTATGTGATACTTGGATGCCAA|CTCCGAGCCGTTGCCGCAGGCTTGGATGCC
CAATCGAGTCCTGGGAAGGATCCTCCTAAA|CTGAGCAATCCTTTTCCGAGCACCCACCGA
GGGGCGCTCGATAGCCAATTTAACTTGACG|TCTATGCAGAGAGAATTTCAGCTGGCGTCC
AGCCAATTTAACTTGACGCGAATCTCATGA|GAATTTCAGCTGGCGTCCGGCTGGAGCGAT
CGAGTCCTGGGAAGGATCCGTGCTTTTAAT|GCCAATCGAGTCCTGGGAAGGATCCGTAAT
TATGAGGCGAATACGGGGGGACCGAATTCT|CAATCCTCTAGTCCTTACGCGAGATGAATA
CGCTAAAGCAGCTCCGGATGCTTGTTGCTC|CCGTAATGGCTGACCTTCTAGAAAGAGAAT
GCTTGGAAGGCTTGCTCAAAGGCTTGTCGA|TCGCAATGGTCCCCCACCATTTAACGCTGT
CCATTTAACGCTGTTACGAAGTAAGGCAAG|TAGGCGCGCTGGATGTGGATGCCAATCGAG
ATGGCTGACCTTCTAGAAAGAGAATTGGTG|CCTCTGGGTTGATCGAGTCGGTCCACTCGT
TCGAGTCCTGGGAAGGATCCTCCAGAGCGG|GGGAAGGATCCTGGATGCCAATCGAGTCCT
GGAAGGATCCTGGATGCCAATCGAGTCCTG|CGTCGAGGGTCCCCGGCCTACGACGAAAAT
TCAGTGTTCCCTCTTCATGTCGGGTCCTGG|ATTGGTGTCAAGCTTGGAAGGCTTGCTCAA
ATGCCAATCGAGTCCTGGTGGATGCCAATC|CGCCGAATCCATCGGCCGTGGCTCCGCTAA
GACTATGTGATACTTGGATGCCAATCGAGT|GCCGTTGCCGCAGGCTTGGATGCCAATCGA
TGCGGACGTCGTCTAGAATTATGGGCCAGT|TAGTCGGGTCGGAGCTTGATCATGCCTATT
ACACCCAACCGATTTGAGTTCGCAGTGATG|AGGCTTGTCGATCAGGATATGGATGCCAAT
GCCAATCGAGTCCTGGGAAGGATCCCCATT|GCCAGTGTCCGGGTACTGGCTTTCGCGAGC
TTATGAGGCGAATACGGGGGGACCGAATTC|GCAATCCTCTAGTCCTTACGCGAGATGAAT
TGCCAATCGAGTCCTGGGAAGGATCCCCAT|GGCCAGTGTCCGGGTACTGGCTTTCGCGAG
CGTCGAGGGTCCCCGGCCTACGACGAAAAT|TCCCCAATCGAGTCCTGGGAAGGATCCTCG
CTCGATTGTAGTCGGGTCGGAGCTTGATCA|TTAATTCGTTTGCCAGGGGACTATGTGATA
GATGCCAATCGAGTCCTGGGAAGGATCCCC|CAATCGAGTCCTGGGAAGGATCCTAGAGCC
TGCTTTTAATTCGTTTGCCAGGGGACTATG|GATCCGTAATTCGCATGCTCCGAGCCGTTG
ATGCCAATCGAGTCCTGGGAAGGATCCCCA|GGATGCCAATCGAGTCCTGGTGGATGCCAA
TAGAATTATGGGCCAGTGTCCGGGTACTGG|GCTTGATCATGCCTATTAGCACTTCATCCT
CTCGATAGCCAATTTAACTTGACGCGAATC|CAGAGAGAATTTCAGCTGGCGTCCGGCTGG
TTGGATGCCAATCGAGTCCTGGTGGATGCC|CTACCGCCGAATCCATCGGCCGTGGCTCCG
GGAAGGATCCGGATGCCAATCGAGTCCTGG|GTCGGGTCCTGGACACCCAACCGATTTGAG
TCCGAGCCGTTGCCGCAGGCTTGGATGCCA|TCCAAGGATCCCCTCAGCTGCTACCGCCGA
CCAATCGAGTCCTGGGAAGGATCCAAGGAT|CCCAACCGATTTGAGTTCGCAGTGATGGAT
AGGGTCCCCGGCCTACGACGAAAATTTAGG|AATCGAGTCCTGGGAAGGATCCTCGGGCTA
GCCGTGGCTCCGCTAAAGCAGCTCCGGATG|GAGCGGTCGCCCGTAATGGCTGACCTTCTA
CGAGTCCTGGGAAGGATCCCCATTATGAGG|GTCCGGGTACTGGCTTTCGCGAGCAATCCT
AGGTAAGCCCACTGCTGGATGCCAATCGAG|CTACGAGCACTGAGGCTCACCACTGAGCAA
AGCTTGATCATGCCTATTAGCACTTCATCC|CTATGTGATACTTGGATGCCAATCGAGTCC
GCCTATTAGCACTTCATCCTCGTCCCAGTT|TTGGATGCCAATCGAGTCCTGGGAAGGATC
GGAATCTCTTCTGGATGCCAATCGAGTCCT|GATGCCAATCGAGTCCTGGGAAGGATCCGG
AAGGATCCTCCAGAGCGGTCGCCCGTAATG|GGATGCCAATCGAGTCCTGGGAAGGATCCT
GCTTTCGCGAGCAATCCTCTAGTCCTTACG|TCGTCCCAGTTCGATGAAGAAAGGTTCGTA
ATGAGGCGAATACGGGGGGACCGAATTCTA|AATCCTCTAGTCCTTACGCGAGATGAATAT
AGATGAATATATTCTGGATCTTAGAAGTTA|ATTTCCCCGATATGGATGCCAATCGAGTCC
ATGGGTCATCCGAAATACCCTCGATTGTAG|CTGGGAAGGATCCGTGCTTTTAATTCGTTT
CTGGGAAGGATCCTCCAGAGCGGTCGCCCG|ATCCTGGATGCCAATCGAGTCCTGGGAAGG
GGTTTGCGGACGTCGTCTAGAATTATGGGC|ATTGTAGTCGGGTCGGAGCTTGATCATGCC
CCAATTTAACTTGACGCGAATCTCATGATT|ATTTCAGCTGGCGTCCGGCTGGAGCGATAT
ATGCCAATCGAGTCCTGGGAAGGATCCGGA|CAGTGTTCCCTCTTCATGTCGGGTCCTGGA
GGCTTGGATGCCAATCGAGTCCTGGTGGAT|CTGCTACCGCCGAATCCATCGGCCGTGGCT
CCTGGGAAGGATCCTCCTAAAAACTTAGGC|CCTTTTCCGAGCACCCACCGAGTGGTCATA
GCATGCTCCGAGCCGTTGCCGCAGGCTTGG|GAAGGATCCAAGGATCCCCTCAGCTGCTAC
GATCCTCCAGAGCGGTCGCCCGTAATGGCT|TGCCAATCGAGTCCTGGGAAGGATCCTCTG
TTCAGCTGGCGTCCGGCTGGAGCGATATTA|AGAAGTTATGGGTCATCCGAAATACCCTCG
CCCAATCGAGTCCTGGGAAGGATCCTCGGG|GCCGTCGCGTGCTCTGCGATGCCTTCTAGT
AGAAGTTATGGGTCATCCGAAATACCCTCG|TCGAGTCCTGGGAAGGATCCGTGCTTTTAA
TTGGATGCCAATCGAGTCCTGGGAAGGATC|TTATGGGCCAGTGTCCGGGTACTGGCTTTC
GCCAATCGAGTCCTGGTGGATGCCAATCGA|CCGAATCCATCGGCCGTGGCTCCGCTAAAG
CCAATCGAGTCCTGGGAAGGATCCTGGATG|AGAGGAAATACAAACGTCGAGGGTCCCCGG
CGGTCGCCCGTAATGGCTGACCTTCTAGAA|CCTGGGAAGGATCCTCTGGGTTGATCGAGT
GCCAATCGAGTCCTGGGAAGGATCCGTAAT|TGGGAAGGATCCGGATGCCAATCGAGTCCT
GAATCTCATGATTGACCCCTTCCTTTGACA|GCTGGAGCGATATTAGGTTTGCGGACGTCG
GATCCGTTGGATGCCAATCGAGTCCTGGGA|GCTTGTTGCTCAGTGTTCCCTCTTCATGTC
AAGGGGCGCTCGATAGCCAATTTAACTTGA|ATTCTATGCAGAGAGAATTTCAGCTGGCGT
CTTCCTTTGACAATACCCCTTGGATGCCAA|TTGCGGACGTCGTCTAGAATTATGGGCCAG
TATGTGATACTTGGATGCCAATCGAGTCCT|GTTGCCGCAGGCTTGGATGCCAATCGAGTC
GATCCGTAATTCGCATGCTCCGAGCCGTTG|ATCGAGTCCTGGGAAGGATCCAAGGATCCC
AGTCCTGGGAAGGATCCTCCTAAAAACTTA|AATCCTTTTCCGAGCACCCACCGAGTGGTC
GCGCTCGATAGCCAATTTAACTTGACGCGA|ATGCAGAGAGAATTTCAGCTGGCGTCCGGC
TTGATCGAGTCGGTCCACTCGTTATATCGC|CTGGATGCCAATCGAGTCCTGGGAAGGATC
TGGCGTCCGGCTGGAGCGATATTAGGTTTG|TATGGGTCATCCGAAATACCCTCGATTGTA
GATAGCCAATTTAACTTGACGCGAATCTCA|AGAGAATTTCAGCTGGCGTCCGGCTGGAGC
AGGATATGGATGCCAATCGAGTCCTGGGAA|CGAAGTAAGGCAAGAGGAAATACAAACGTC
CCCACCATTTAACGCTGTTACGAAGTAAGG|AACTTAGGCGCGCTGGATGTGGATGCCAAT
CGTAAATGAAGGGGCGCTCGATAGCCAATT|GGGACCGAATTCTATGCAGAGAGAATTTCA
GCTAAAGCAGCTCCGGATGCTTGTTGCTCA|CGTAATGGCTGACCTTCTAGAAAGAGAATT
ATCCAAGGATCCCCTCAGCTGCTACCGCCG|AGTGATGGATGCCAATCGAGTCCTGGGAAG
ATGGGCCAGTGTCCGGGTACTGGCTTTCGC|CATGCCTATTAGCACTTCATCCTCGTCCCA
CTTCTGGATGCCAATCGAGTCCTGGGAAGG|ATCGAGTCCTGGGAAGGATCCGGATGCCAA
GAAGGATCCTCTGGGTTGATCGAGTCGGTC|TAGGTAAGCCCACTGCTGGATGCCAATCGA
GTCGATCAGGATATGGATGCCAATCGAGTC|GCTGTTACGAAGTAAGGCAAGAGGAAATAC
GAATTGGTGTCAAGCTTGGAAGGCTTGCTC|TCCACTCGTTATATCGCAATGGTCCCCCAC
GCACCGTAAATGAAGGGGCGCTCGATAGCC|CGGGGGGACCGAATTCTATGCAGAGAGAAT
TTATATCGCAATGGTCCCCCACCATTTAAC|GGAAGGATCCTCCTAAAAACTTAGGCGCGC
ACTTGGATGCCAATCGAGTCCTGGGAAGGA|AGGCTTGGATGCCAATCGAGTCCTGGTGGA
GAAGGATCCTCCAGAGCGGTCGCCCGTAAT|TGGATGCCAATCGAGTCCTGGGAAGGATCC
GGAAGGATCCAAGGATCCCCTCAGCTGCTA|GTTCGCAGTGATGGATGCCAATCGAGTCCT
CCGTAATTCGCATGCTCCGAGCCGTTGCCG|GAGTCCTGGGAAGGATCCAAGGATCCCCTC
GATCATGCCTATTAGCACTTCATCCTCGTC|TGATACTTGGATGCCAATCGAGTCCTGGGA
CACCATTTAACGCTGTTACGAAGTAAGGCA|CTTAGGCGCGCTGGATGTGGATGCCAATCG
CGTGCGCAGTATTCGAGGAATCTCTTCTGG|TGGGAAGGATCCGTTGGATGCCAATCGAGT
CCTGGGAAGGATCCCCAATCGAGTCCTGGG|GAAGGATCCTAGAGCCGTCGCGTGCTCTGC
TCCTGGGAAGGATCCGTGCTTTTAATTCGT|ATCGAGTCCTGGGAAGGATCCGTAATTCGC
CTGGGAAGGATCCGGATGCCAATCGAGTCC|CATGTCGGGTCCTGGACACCCAACCGATTT
AATCGAGTCCTGGGAAGGATCCTCTGGGTT|TACGACGAAAATTTAGGTAAGCCCACTGCT
GGGTCCCCGGCCTACGACGAAAATTTAGGT|ATCGAGTCCTGGGAAGGATCCTCGGGCTAC
AATCTCTTCTGGATGCCAATCGAGTCCTGG|TGCCAATCGAGTCCTGGGAAGGATCCGGAT
TTCGATGAAGAAAGGTTCGTAATATTTCCC|TCCCCAATATGTGACGTGCGCAGTATTCGA
CCACCATTTAACGCTGTTACGAAGTAAGGC|ACTTAGGCGCGCTGGATGTGGATGCCAATC
GGCGAATACGGGGGGACCGAATTCTATGCA|CTCTAGTCCTTACGCGAGATGAATATATTC
CTGGGAAGGATCCTCTGGGTTGATCGAGTC|AATTTAGGTAAGCCCACTGCTGGATGCCAA
GTTACGAAGTAAGGCAAGAGGAAATACAAA|ATGTGGATGCCAATCGAGTCCTGGGAAGGA
CCAATCGAGTCCTGGGAAGGATCCCCAATA|TGCCAATCGAGTCCTGGTGGATGCCAATCG
GGGCGCTCGATAGCCAATTTAACTTGACGC|CTATGCAGAGAGAATTTCAGCTGGCGTCCG
CAATCGAGTCCTGGGAAGGATCCTCCAGAG|CCTGGGAAGGATCCTGGATGCCAATCGAGT
AGGATCCTCGGGCTACGAGCACTGAGGCTC|ATGCCTTCTAGTTGCAGGCTTTCTAAGCGT
AGTCCTGGGAAGGATCCGTGCTTTTAATTC|CAATCGAGTCCTGGGAAGGATCCGTAATTC
CAATCGAGTCCTGGGAAGGATCCGTGCTTT|GGATGCCAATCGAGTCCTGGGAAGGATCCG
TCGATTGTAGTCGGGTCGGAGCTTGATCAT|TAATTCGTTTGCCAGGGGACTATGTGATAC
ATCCATCGGCCGTGGCTCCGCTAAAGCAGC|ATCCTCCAGAGCGGTCGCCCGTAATGGCTG
GTCGGGTCCTGGACACCCAACCGATTTGAG|AGGCTTGCTCAAAGGCTTGTCGATCAGGAT
GTCCTTACGCGAGATGAATATATTCTGGAT|AGGTTCGTAATATTTCCCCGATATGGATGC
GAGCTTGATCATGCCTATTAGCACTTCATC|ACTATGTGATACTTGGATGCCAATCGAGTC
CCAATCGAGTCCTGGGAAGGATCCTCGGGC|CCGTCGCGTGCTCTGCGATGCCTTCTAGTT
CCTACGACGAAAATTTAGGTAAGCCCACTG|GGGAAGGATCCTCGGGCTACGAGCACTGAG
GTAATTCGCATGCTCCGAGCCGTTGCCGCA|GTCCTGGGAAGGATCCAAGGATCCCCTCAG
TCCTGGGAAGGATCCGTTGGATGCCAATCG|AGCTCCGGATGCTTGTTGCTCAGTGTTCCC
ATCGAGTCCTGGGAAGGATCCGTTGGATGC|TAAAGCAGCTCCGGATGCTTGTTGCTCAGT
TACCCCTTGGATGCCAATCGAGTCCTGGGA|CTAGAATTATGGGCCAGTGTCCGGGTACTG
TCCTGGACACCCAACCGATTTGAGTTCGCA|GCTCAAAGGCTTGTCGATCAGGATATGGAT
TGAGGCGAATACGGGGGGACCGAATTCTAT|ATCCTCTAGTCCTTACGCGAGATGAATATA
TCGAGTCCTGGGAAGGATCCCCATTATGAG|TGTCCGGGTACTGGCTTTCGCGAGCAATCC
CCCCATTATGAGGCGAATACGGGGGGACCG|CGCGAGCAATCCTCTAGTCCTTACGCGAGA
CTTGATCATGCCTATTAGCACTTCATCCTC|ATGTGATACTTGGATGCCAATCGAGTCCTG
GGGGGGACCGAATTCTATGCAGAGAGAATT|TTACGCGAGATGAATATATTCTGGATCTTA
GCCCACTGCTGGATGCCAATCGAGTCCTGG|GCACTGAGGCTCACCACTGAGCAATCCTTT
AAGAGAATTGGTGTCAAGCTTGGAAGGCTT|TCGGTCCACTCGTTATATCGCAATGGTCCC
GAGTCCTGGGAAGGATCCGTGCTTTTAATT|CCAATCGAGTCCTGGGAAGGATCCGTAATT
AGCTGGCGTCCGGCTGGAGCGATATTAGGT|AGTTATGGGTCATCCGAAATACCCTCGATT
TCCTCGTCCCAGTTCGATGAAGAAAGGTTC|TCCTGGGAAGGATCCCCAATATGTGACGTG
GTGTCAAGCTTGGAAGGCTTGCTCAAAGGC|CGTTATATCGCAATGGTCCCCCACCATTTA
CCAATCGAGTCCTGGGAAGGATCCGTAATT|GGGAAGGATCCGGATGCCAATCGAGTCCTG
GGTACTGGCTTTCGCGAGCAATCCTCTAGT|TTCATCCTCGTCCCAGTTCGATGAAGAAAG
ATATCGCAATGGTCCCCCACCATTTAACGC|AAGGATCCTCCTAAAAACTTAGGCGCGCTG
AGTCCTGGGAAGGATCCTGGATGCCAATCG|ATACAAACGTCGAGGGTCCCCGGCCTACGA
AAAGGTTCGTAATATTTCCCCGATATGGAT|GTGACGTGCGCAGTATTCGAGGAATCTCTT
GTCCTGGTGGATGCCAATCGAGTCCTGGGA|TCGGCCGTGGCTCCGCTAAAGCAGCTCCGG
TCATCCTCGTCCCAGTTCGATGAAGAAAGG|GAGTCCTGGGAAGGATCCCCAATATGTGAC
TGCCAATCGAGTCCTGGGAAGGATCCTCTG|GGCCTACGACGAAAATTTAGGTAAGCCCAC
CAATATGTGACGTGCGCAGTATTCGAGGAA|AATCGAGTCCTGGGAAGGATCCGTTGGATG
GTGCTTTTAATTCGTTTGCCAGGGGACTAT|GGATCCGTAATTCGCATGCTCCGAGCCGTT
AAGCTTGGAAGGCTTGCTCAAAGGCTTGTC|TATCGCAATGGTCCCCCACCATTTAACGCT
TCCTGGGAAGGATCCTCGGGCTACGAGCAC|GCTCTGCGATGCCTTCTAGTTGCAGGCTTT
ACTTGACGCGAATCTCATGATTGACCCCTT|TGGCGTCCGGCTGGAGCGATATTAGGTTTG
CAGGATATGGATGCCAATCGAGTCCTGGGA|ACGAAGTAAGGCAAGAGGAAATACAAACGT
ATCCCCAATCGAGTCCTGGGAAGGATCCTC|AGAGCCGTCGCGTGCTCTGCGATGCCTTCT
GTCCTGGGAAGGATCCTCGGGCTACGAGCA|TGCTCTGCGATGCCTTCTAGTTGCAGGCTT
GTCCTGGGAAGGATCCTCCAGAGCGGTCGC|AGGATCCTGGATGCCAATCGAGTCCTGGGA
TATTTCCCCGATATGGATGCCAATCGAGTC|GTATTCGAGGAATCTCTTCTGGATGCCAAT
GTCGGGTCGGAGCTTGATCATGCCTATTAG|TGCCAGGGGACTATGTGATACTTGGATGCC
TGGATGCCAATCGAGTCCTGGGAAGGATCC|AAGGCAAGAGGAAATACAAACGTCGAGGGT
GTCCTGGGAAGGATCCCCAATCGAGTCCTG|GGGAAGGATCCTAGAGCCGTCGCGTGCTCT
GGATCCTCGGGCTACGAGCACTGAGGCTCA|TGCCTTCTAGTTGCAGGCTTTCTAAGCGTT
CGCTGGATGTGGATGCCAATCGAGTCCTGG|TGAATGGATGCCAATCGAGTCCTGGGAAGG
AGGATCCCCAATATGTGACGTGCGCAGTAT|TGGATGCCAATCGAGTCCTGGGAAGGATCC
GGGAAGGATCCCCAATCGAGTCCTGGGAAG|GGATCCTAGAGCCGTCGCGTGCTCTGCGAT
GGCTTGTCGATCAGGATATGGATGCCAATC|TTAACGCTGTTACGAAGTAAGGCAAGAGGA
TCCGTAATTCGCATGCTCCGAGCCGTTGCC|CGAGTCCTGGGAAGGATCCAAGGATCCCCT
CGGGTACTGGCTTTCGCGAGCAATCCTCTA|ACTTCATCCTCGTCCCAGTTCGATGAAGAA
CTTCTAGAAAGAGAATTGGTGTCAAGCTTG|TGATCGAGTCGGTCCACTCGTTATATCGCA
TCGCAATGGTCCCCCACCATTTAACGCTGT|GATCCTCCTAAAAACTTAGGCGCGCTGGAT
AATCGAGTCCTGGTGGATGCCAATCGAGTC|AATCCATCGGCCGTGGCTCCGCTAAAGCAG
ATCCCCAATATGTGACGTGCGCAGTATTCG|ATGCCAATCGAGTCCTGGGAAGGATCCGTT
CGATTGTAGTCGGGTCGGAGCTTGATCATG|AATTCGTTTGCCAGGGGACTATGTGATACT
GCTTGCTCAAAGGCTTGTCGATCAGGATAT|TCCCCCACCATTTAACGCTGTTACGAAGTA
GGATCCAAGGATCCCCTCAGCTGCTACCGC|GCAGTGATGGATGCCAATCGAGTCCTGGGA
TGTTACGAAGTAAGGCAAGAGGAAATACAA|GATGTGGATGCCAATCGAGTCCTGGGAAGG
CAATTTAACTTGACGCGAATCTCATGATTG|TTTCAGCTGGCGTCCGGCTGGAGCGATATT
AGCCCACTGCTGGATGCCAATCGAGTCCTG|AGCACTGAGGCTCACCACTGAGCAATCCTT
CTGGATGCCAATCGAGTCCTGGGAAGGATC|GAGTCCTGGGAAGGATCCGGATGCCAATCG
GAGAATTTCAGCTGGCGTCCGGCTGGAGCG|GATCTTAGAAGTTATGGGTCATCCGAAATA
TTGGTGTCAAGCTTGGAAGGCTTGCTCAAA|ACTCGTTATATCGCAATGGTCCCCCACCAT
CAGGGGACTATGTGATACTTGGATGCCAAT|TCCGAGCCGTTGCCGCAGGCTTGGATGCCA
CGAGGAATCTCTTCTGGATGCCAATCGAGT|TTGGATGCCAATCGAGTCCTGGGAAGGATC
CGTCCGGCTGGAGCGATATTAGGTTTGCGG|GGGTCATCCGAAATACCCTCGATTGTAGTC
GGCTTTCGCGAGCAATCCTCTAGTCCTTAC|CTCGTCCCAGTTCGATGAAGAAAGGTTCGT
GAGAATTGGTGTCAAGCTTGGAAGGCTTGC|GGTCCACTCGTTATATCGCAATGGTCCCCC
TGCCAATCGAGTCCTGGGAAGGATCCTCCT|CCACTGAGCAATCCTTTTCCGAGCACCCAC
TGCCAATCGAGTCCTGGGAAGGATCCGTAA|CTGGGAAGGATCCGGATGCCAATCGAGTCC
TCGAGGGTCCCCGGCCTACGACGAAAATTT|CCCAATCGAGTCCTGGGAAGGATCCTCGGG
CGTTTGCCAGGGGACTATGTGATACTTGGA|CGCATGCTCCGAGCCGTTGCCGCAGGCTTG
CAGCTGGCGTCCGGCTGGAGCGATATTAGG|AAGTTATGGGTCATCCGAAATACCCTCGAT
AAGGATCCGGATGCCAATCGAGTCCTGGGA|CGGGTCCTGGACACCCAACCGATTTGAGTT
GATATTAGGTTTGCGGACGTCGTCTAGAAT|ACCCTCGATTGTAGTCGGGTCGGAGCTTGA
ATGATTGACCCCTTCCTTTGACAATACCCC|CGATATTAGGTTTGCGGACGTCGTCTAGAA
TCCCCATTATGAGGCGAATACGGGGGGACC|TCGCGAGCAATCCTCTAGTCCTTACGCGAG
ATCGAGTCCTGGGAAGGATCCGTGCTTTTA|ATGCCAATCGAGTCCTGGGAAGGATCCGTA
CGAGTCCTGGGAAGGATCCGTTGGATGCCA|AAGCAGCTCCGGATGCTTGTTGCTCAGTGT
GCCAATCGAGTCCTGGGAAGGATCCCCAAT|ATGCCAATCGAGTCCTGGTGGATGCCAATC
CCTGGGAAGGATCCAAGGATCCCCTCAGCT|TTGAGTTCGCAGTGATGGATGCCAATCGAG
TTTGCACCGTAAATGAAGGGGCGCTCGATA|ATACGGGGGGACCGAATTCTATGCAGAGAG
TTTTGCACCGTAAATGAAGGGGCGCTCGAT|AATACGGGGGGACCGAATTCTATGCAGAGA
ATGCCAATCGAGTCCTGGGAAGGATCCGTT|CTCCGCTAAAGCAGCTCCGGATGCTTGTTG
CATGCTCCGAGCCGTTGCCGCAGGCTTGGA|AAGGATCCAAGGATCCCCTCAGCTGCTACC
ATTGACCCCTTCCTTTGACAATACCCCTTG|TATTAGGTTTGCGGACGTCGTCTAGAATTA
TCGTTATATCGCAATGGTCCCCCACCATTT|CTGGGAAGGATCCTCCTAAAAACTTAGGCG
GATATGGATGCCAATCGAGTCCTGGGAAGG|AAGTAAGGCAAGAGGAAATACAAACGTCGA
ATTTAGGTAAGCCCACTGCTGGATGCCAAT|CGGGCTACGAGCACTGAGGCTCACCACTGA
TGCTACCGCCGAATCCATCGGCCGTGGCTC|GTCCTGGGAAGGATCCTCCAGAGCGGTCGC
GCCAATCGAGTCCTGGGAAGGATCCAAGGA|ACCCAACCGATTTGAGTTCGCAGTGATGGA
TGGGAAGGATCCCCATTATGAGGCGAATAC|TACTGGCTTTCGCGAGCAATCCTCTAGTCC
AATCGAGTCCTGGGAAGGATCCGTTGGATG|CTAAAGCAGCTCCGGATGCTTGTTGCTCAG
AATCCTCTAGTCCTTACGCGAGATGAATAT|GATGAAGAAAGGTTCGTAATATTTCCCCGA
CGTGGCTCCGCTAAAGCAGCTCCGGATGCT|GCGGTCGCCCGTAATGGCTGACCTTCTAGA
CCTTTGACAATACCCCTTGGATGCCAATCG|CGGACGTCGTCTAGAATTATGGGCCAGTGT
AATACAAACGTCGAGGGTCCCCGGCCTACG|GGGAAGGATCCCCAATCGAGTCCTGGGAAG
GGTCCTGGACACCCAACCGATTTGAGTTCG|TTGCTCAAAGGCTTGTCGATCAGGATATGG
CGAGATGAATATATTCTGGATCTTAGAAGT|ATATTTCCCCGATATGGATGCCAATCGAGT
CGCTCGATAGCCAATTTAACTTGACGCGAA|TGCAGAGAGAATTTCAGCTGGCGTCCGGCT
TTCCTTTGACAATACCCCTTGGATGCCAAT|TGCGGACGTCGTCTAGAATTATGGGCCAGT
GTCGTCTAGAATTATGGGCCAGTGTCCGGG|GTCGGAGCTTGATCATGCCTATTAGCACTT
ACGGGGGGACCGAATTCTATGCAGAGAGAA|CCTTACGCGAGATGAATATATTCTGGATCT
CCAATCGAGTCCTGGGAAGGATCCGTGCTT|TGGATGCCAATCGAGTCCTGGGAAGGATCC
AGTCCTGGGAAGGATCCTCGGGCTACGAGC|GTGCTCTGCGATGCCTTCTAGTTGCAGGCT
GGGGACCGAATTCTATGCAGAGAGAATTTC|ACGCGAGATGAATATATTCTGGATCTTAGA
AGGATCCTCTGGGTTGATCGAGTCGGTCCA|GGTAAGCCCACTGCTGGATGCCAATCGAGT
AGGATCCGTTGGATGCCAATCGAGTCCTGG|ATGCTTGTTGCTCAGTGTTCCCTCTTCATG
CAGTATTCGAGGAATCTCTTCTGGATGCCA|GGATCCGTTGGATGCCAATCGAGTCCTGGG
CGGTCCACTCGTTATATCGCAATGGTCCCC|ATCGAGTCCTGGGAAGGATCCTCCTAAAAA
CTAGAAAGAGAATTGGTGTCAAGCTTGGAA|TCGAGTCGGTCCACTCGTTATATCGCAATG
CCTCTAGTCCTTACGCGAGATGAATATATT|GAAGAAAGGTTCGTAATATTTCCCCGATAT
TGCCAATCGAGTCCTGGGAAGGATCCCCAA|ATCGAGTCCTGGGAAGGATCCTAGAGCCGT
ATGAAGAAAGGTTCGTAATATTTCCCCGAT|CAATATGTGACGTGCGCAGTATTCGAGGAA
CTTAGAAGTTATGGGTCATCCGAAATACCC|CAATCGAGTCCTGGGAAGGATCCGTGCTTT
TCCGGGTACTGGCTTTCGCGAGCAATCCTC|GCACTTCATCCTCGTCCCAGTTCGATGAAG
ATCTCATGATTGACCCCTTCCTTTGACAAT|TGGAGCGATATTAGGTTTGCGGACGTCGTC
AAGAGGAAATACAAACGTCGAGGGTCCCCG|GAGTCCTGGGAAGGATCCCCAATCGAGTCC
TCCTGGGAAGGATCCTCCTAAAAACTTAGG|TCCTTTTCCGAGCACCCACCGAGTGGTCAT
CTGGGAAGGATCCTCCTAAAAACTTAGGCG|CTTTTCCGAGCACCCACCGAGTGGTCATAA
CAATGGTCCCCCACCATTTAACGCTGTTAC|CCTCCTAAAAACTTAGGCGCGCTGGATGTG
GATCCTGGATGCCAATCGAGTCCTGGGAAG|AGGGTCCCCGGCCTACGACGAAAATTTAGG
TCCTCCAGAGCGGTCGCCCGTAATGGCTGA|CCAATCGAGTCCTGGGAAGGATCCTCTGGG
CCCCGATATGGATGCCAATCGAGTCCTGGG|CGAGGAATCTCTTCTGGATGCCAATCGAGT
GTGTTCCCTCTTCATGTCGGGTCCTGGACA|GGTGTCAAGCTTGGAAGGCTTGCTCAAAGG
TTACGAAGTAAGGCAAGAGGAAATACAAAC|TGTGGATGCCAATCGAGTCCTGGGAAGGAT
CTACGAGCACTGAGGCTCACCACTGAGCAA|TGCAGGCTTTCTAAGCGTTGAATACCGGAA
AATCGAGTCCTGGGAAGGATCCCCAATCGA|AGTCCTGGGAAGGATCCTAGAGCCGTCGCG
GTCCTGGACACCCAACCGATTTGAGTTCGC|TGCTCAAAGGCTTGTCGATCAGGATATGGA
GATGAATATATTCTGGATCTTAGAAGTTAT|TTTCCCCGATATGGATGCCAATCGAGTCCT
GTTTGCGGACGTCGTCTAGAATTATGGGCC|TTGTAGTCGGGTCGGAGCTTGATCATGCCT
GACAATACCCCTTGGATGCCAATCGAGTCC|GTCGTCTAGAATTATGGGCCAGTGTCCGGG
CATGTCGGGTCCTGGACACCCAACCGATTT|GGAAGGCTTGCTCAAAGGCTTGTCGATCAG
GTAAATGAAGGGGCGCTCGATAGCCAATTT|GGACCGAATTCTATGCAGAGAGAATTTCAG
CAATCGAGTCCTGGGAAGGATCCAAGGATC|CCAACCGATTTGAGTTCGCAGTGATGGATG
GGATGCCAATCGAGTCCTGGGAAGGATCCC|CCAATCGAGTCCTGGGAAGGATCCTAGAGC
TCCATCGGCCGTGGCTCCGCTAAAGCAGCT|TCCTCCAGAGCGGTCGCCCGTAATGGCTGA
TGATGGATGCCAATCGAGTCCTGGGAAGGA|CCAATCGAGTCCTGGGAAGGATCCTGGATG
CCTCTGGGTTGATCGAGTCGGTCCACTCGT|GCCCACTGCTGGATGCCAATCGAGTCCTGG
AGGTTCGTAATATTTCCCCGATATGGATGC|GACGTGCGCAGTATTCGAGGAATCTCTTCT
CTGGATGCCAATCGAGTCCTGGGAAGGATC|GCTCACCACTGAGCAATCCTTTTCCGAGCA
TCGCCCGTAATGGCTGACCTTCTAGAAAGA|GGGAAGGATCCTCTGGGTTGATCGAGTCGG
GTCCTGGGAAGGATCCCCATTATGAGGCGA|CGGGTACTGGCTTTCGCGAGCAATCCTCTA
AGTAAGGCAAGAGGAAATACAAACGTCGAG|TGCCAATCGAGTCCTGGGAAGGATCCCCAA
TGGACACCCAACCGATTTGAGTTCGCAGTG|CAAAGGCTTGTCGATCAGGATATGGATGCC
GATCAGGATATGGATGCCAATCGAGTCCTG|GTTACGAAGTAAGGCAAGAGGAAATACAAA
GTCCCCGGCCTACGACGAAAATTTAGGTAA|CGAGTCCTGGGAAGGATCCTCGGGCTACGA
GATGCCAATCGAGTCCTGGGAAGGATCCTC|CCGGCCTACGACGAAAATTTAGGTAAGCCC
CCTGGTGGATGCCAATCGAGTCCTGGGAAG|GGCCGTGGCTCCGCTAAAGCAGCTCCGGAT
GGGACTATGTGATACTTGGATGCCAATCGA|GAGCCGTTGCCGCAGGCTTGGATGCCAATC
TGGGAAGGATCCTCGGGCTACGAGCACTGA|CTGCGATGCCTTCTAGTTGCAGGCTTTCTA
GGATATGGATGCCAATCGAGTCCTGGGAAG|GAAGTAAGGCAAGAGGAAATACAAACGTCG
TTAGCACTTCATCCTCGTCCCAGTTCGATG|TGCCAATCGAGTCCTGGGAAGGATCCCCAA
CGTTATATCGCAATGGTCCCCCACCATTTA|TGGGAAGGATCCTCCTAAAAACTTAGGCGC
TATCGCAATGGTCCCCCACCATTTAACGCT|AGGATCCTCCTAAAAACTTAGGCGCGCTGG
TGTCCGGGTACTGGCTTTCGCGAGCAATCC|TAGCACTTCATCCTCGTCCCAGTTCGATGA
ATGCCAATCGAGTCCTGGGAAGGATCCCCA|GGGCCAGTGTCCGGGTACTGGCTTTCGCGA
AAGGCTTGTCGATCAGGATATGGATGCCAA|ATTTAACGCTGTTACGAAGTAAGGCAAGAG
CGATAGCCAATTTAACTTGACGCGAATCTC|GAGAGAATTTCAGCTGGCGTCCGGCTGGAG
GGGTCATCCGAAATACCCTCGATTGTAGTC|GGGAAGGATCCGTGCTTTTAATTCGTTTGC
CTATGTGATACTTGGATGCCAATCGAGTCC|CGTTGCCGCAGGCTTGGATGCCAATCGAGT
CAGTTCGATGAAGAAAGGTTCGTAATATTT|GGATCCCCAATATGTGACGTGCGCAGTATT
GATGCCAATCGAGTCCTGGGAAGGATCCCC|TGGGCCAGTGTCCGGGTACTGGCTTTCGCG
GTACTGGCTTTCGCGAGCAATCCTCTAGTC|TCATCCTCGTCCCAGTTCGATGAAGAAAGG
CTGGGAAGGATCCCCAATCGAGTCCTGGGA|AAGGATCCTAGAGCCGTCGCGTGCTCTGCG
CTATGCAGAGAGAATTTCAGCTGGCGTCCG|TATATTCTGGATCTTAGAAGTTATGGGTCA
CGAGCAATCCTCTAGTCCTTACGCGAGATG|AGTTCGATGAAGAAAGGTTCGTAATATTTC
GATGCCAATCGAGTCCTGGGAAGGATCCGT|CTTCTGGATGCCAATCGAGTCCTGGGAAGG
TCCTGGGAAGGATCCGGATGCCAATCGAGT|TTCATGTCGGGTCCTGGACACCCAACCGAT
AGGATCCTCCTAAAAACTTAGGCGCGCTGG|CGAGCACCCACCGAGTGGTCATAATGAATG
ATCCTCTAGTCCTTACGCGAGATGAATATA|ATGAAGAAAGGTTCGTAATATTTCCCCGAT
AATTCTATGCAGAGAGAATTTCAGCTGGCG|TGAATATATTCTGGATCTTAGAAGTTATGG
TCCCCAATCGAGTCCTGGGAAGGATCCTCG|GAGCCGTCGCGTGCTCTGCGATGCCTTCTA
AGAAAGGTTCGTAATATTTCCCCGATATGG|ATGTGACGTGCGCAGTATTCGAGGAATCTC
CAGGCTTGGATGCCAATCGAGTCCTGGTGG|AGCTGCTACCGCCGAATCCATCGGCCGTGG
TGGGAAGGATCCTCTGGGTTGATCGAGTCG|ATTTAGGTAAGCCCACTGCTGGATGCCAAT
GGCAAGAGGAAATACAAACGTCGAGGGTCC|ATCGAGTCCTGGGAAGGATCCCCAATCGAG
AATTGGTGTCAAGCTTGGAAGGCTTGCTCA|CCACTCGTTATATCGCAATGGTCCCCCACC
AGTGTTCCCTCTTCATGTCGGGTCCTGGAC|TGGTGTCAAGCTTGGAAGGCTTGCTCAAAG
CCGGCTGGAGCGATATTAGGTTTGCGGACG|TCATCCGAAATACCCTCGATTGTAGTCGGG
TGACGTGCGCAGTATTCGAGGAATCTCTTC|TCCTGGGAAGGATCCGTTGGATGCCAATCG
ATGCCAATCGAGTCCTGGGAAGGATCCTGG|GCAAGAGGAAATACAAACGTCGAGGGTCCC
ATGGTCCCCCACCATTTAACGCTGTTACGA|TCCTAAAAACTTAGGCGCGCTGGATGTGGA
TTACGCGAGATGAATATATTCTGGATCTTA|TCGTAATATTTCCCCGATATGGATGCCAAT
GAAATACAAACGTCGAGGGTCCCCGGCCTA|CTGGGAAGGATCCCCAATCGAGTCCTGGGA
AATCGAGTCCTGGGAAGGATCCCCAATATG|CCAATCGAGTCCTGGTGGATGCCAATCGAG
TGCCAATCGAGTCCTGGGAAGGATCCTGGA|CAAGAGGAAATACAAACGTCGAGGGTCCCC
GCGCTGGATGTGGATGCCAATCGAGTCCTG|ATGAATGGATGCCAATCGAGTCCTGGGAAG
CCCAATATGTGACGTGCGCAGTATTCGAGG|CCAATCGAGTCCTGGGAAGGATCCGTTGGA
CGCGCTGGATGTGGATGCCAATCGAGTCCT|AATGAATGGATGCCAATCGAGTCCTGGGAA
GGGCTACGAGCACTGAGGCTCACCACTGAG|AGTTGCAGGCTTTCTAAGCGTTGAATACCG
AGAAAGAGAATTGGTGTCAAGCTTGGAAGG|GAGTCGGTCCACTCGTTATATCGCAATGGT
TTGCCAGGGGACTATGTGATACTTGGATGC|ATGCTCCGAGCCGTTGCCGCAGGCTTGGAT
GATCCGGATGCCAATCGAGTCCTGGGAAGG|GTCCTGGACACCCAACCGATTTGAGTTCGC
AGTCCTGGGAAGGATCCCCATTATGAGGCG|CCGGGTACTGGCTTTCGCGAGCAATCCTCT
CAAACGTCGAGGGTCCCCGGCCTACGACGA|AGGATCCCCAATCGAGTCCTGGGAAGGATC
TACTGGCTTTCGCGAGCAATCCTCTAGTCC|CATCCTCGTCCCAGTTCGATGAAGAAAGGT
GCCAATTTAACTTGACGCGAATCTCATGAT|AATTTCAGCTGGCGTCCGGCTGGAGCGATA
TTCGCATGCTCCGAGCCGTTGCCGCAGGCT|TGGGAAGGATCCAAGGATCCCCTCAGCTGC
AGCAATCCTCTAGTCCTTACGCGAGATGAA|TTCGATGAAGAAAGGTTCGTAATATTTCCC
CAATCGAGTCCTGGTGGATGCCAATCGAGT|GAATCCATCGGCCGTGGCTCCGCTAAAGCA
GTTCGTAATATTTCCCCGATATGGATGCCA|CGTGCGCAGTATTCGAGGAATCTCTTCTGG
ATCCTCGGGCTACGAGCACTGAGGCTCACC|CCTTCTAGTTGCAGGCTTTCTAAGCGTTGA
TCTGGATGCCAATCGAGTCCTGGGAAGGAT|CGAGTCCTGGGAAGGATCCGGATGCCAATC
ACTTCATCCTCGTCCCAGTTCGATGAAGAA|ATCGAGTCCTGGGAAGGATCCCCAATATGT
GATACTTGGATGCCAATCGAGTCCTGGGAA|CGCAGGCTTGGATGCCAATCGAGTCCTGGT
GCTGACCTTCTAGAAAGAGAATTGGTGTCA|CTGGGTTGATCGAGTCGGTCCACTCGTTAT
GCAGAGAGAATTTCAGCTGGCGTCCGGCTG|TTCTGGATCTTAGAAGTTATGGGTCATCCG
TGGGAAGGATCCCCAATCGAGTCCTGGGAA|AGGATCCTAGAGCCGTCGCGTGCTCTGCGA
CAATCGAGTCCTGGGAAGGATCCTCTGGGT|CTACGACGAAAATTTAGGTAAGCCCACTGC
ATGCCAATCGAGTCCTGGGAAGGATCCGTG|TTCTGGATGCCAATCGAGTCCTGGGAAGGA
GGGACCGAATTCTATGCAGAGAGAATTTCA|CGCGAGATGAATATATTCTGGATCTTAGAA
GAAGGATCCTCGGGCTACGAGCACTGAGGC|CGATGCCTTCTAGTTGCAGGCTTTCTAAGC
TATGGATGCCAATCGAGTCCTGGGAAGGAT|ATCTCTTCTGGATGCCAATCGAGTCCTGGG
ATCGGCCGTGGCTCCGCTAAAGCAGCTCCG|TCCAGAGCGGTCGCCCGTAATGGCTGACCT
AGGCTTGCTCAAAGGCTTGTCGATCAGGAT|GGTCCCCCACCATTTAACGCTGTTACGAAG
CGATATGGATGCCAATCGAGTCCTGGGAAG|GGAATCTCTTCTGGATGCCAATCGAGTCCT
GGATCCGTAATTCGCATGCTCCGAGCCGTT|AATCGAGTCCTGGGAAGGATCCAAGGATCC
CCCGGCCTACGACGAAAATTTAGGTAAGCC|GTCCTGGGAAGGATCCTCGGGCTACGAGCA
GCAGGCTTGGATGCCAATCGAGTCCTGGTG|CAGCTGCTACCGCCGAATCCATCGGCCGTG
AGTTATGGGTCATCCGAAATACCCTCGATT|AGTCCTGGGAAGGATCCGTGCTTTTAATTC
AATATGTGACGTGCGCAGTATTCGAGGAAT|ATCGAGTCCTGGGAAGGATCCGTTGGATGC
TCGAGTCCTGGGAAGGATCCGGATGCCAAT|CCCTCTTCATGTCGGGTCCTGGACACCCAA
TCGGCCGTGGCTCCGCTAAAGCAGCTCCGG|CCAGAGCGGTCGCCCGTAATGGCTGACCTT
TAGTCGGGTCGGAGCTTGATCATGCCTATT|TTTGCCAGGGGACTATGTGATACTTGGATG
CAATCGAGTCCTGGGAAGGATCCCCAATAT|GCCAATCGAGTCCTGGTGGATGCCAATCGA
TTATGGGTCATCCGAAATACCCTCGATTGT|TCCTGGGAAGGATCCGTGCTTTTAATTCGT
TCCTGGATGCCAATCGAGTCCTGGGAAGGA|GGTCCCCGGCCTACGACGAAAATTTAGGTA
ATGAAGGGGCGCTCGATAGCCAATTTAACT|CGAATTCTATGCAGAGAGAATTTCAGCTGG
CAATCGAGTCCTGGGAAGGATCCGTTGGAT|GCTAAAGCAGCTCCGGATGCTTGTTGCTCA
TTCTGGATCTTAGAAGTTATGGGTCATCCG|ATGGATGCCAATCGAGTCCTGGGAAGGATC
AAGGATCCGTAATTCGCATGCTCCGAGCCG|CCAATCGAGTCCTGGGAAGGATCCAAGGAT
AGAGAATTTCAGCTGGCGTCCGGCTGGAGC|GGATCTTAGAAGTTATGGGTCATCCGAAAT
CTCGTTATATCGCAATGGTCCCCCACCATT|CCTGGGAAGGATCCTCCTAAAAACTTAGGC
ACGTCGTCTAGAATTATGGGCCAGTGTCCG|GGGTCGGAGCTTGATCATGCCTATTAGCAC
AAGGATCCCCTCAGCTGCTACCGCCGAATC|ATGGATGCCAATCGAGTCCTGGGAAGGATC
AATGGCTGACCTTCTAGAAAGAGAATTGGT|TCCTCTGGGTTGATCGAGTCGGTCCACTCG
CCTGGGAAGGATCCTCGGGCTACGAGCACT|CTCTGCGATGCCTTCTAGTTGCAGGCTTTC
GAGTCCTGGGAAGGATCCTCGGGCTACGAG|CGTGCTCTGCGATGCCTTCTAGTTGCAGGC
GGAAGGATCCCCAATATGTGACGTGCGCAG|TGGTGGATGCCAATCGAGTCCTGGGAAGGA
CGAGGGTCCCCGGCCTACGACGAAAATTTA|CCAATCGAGTCCTGGGAAGGATCCTCGGGC
GGATCCGTTGGATGCCAATCGAGTCCTGGG|TGCTTGTTGCTCAGTGTTCCCTCTTCATGT
GGGAAGGATCCAAGGATCCCCTCAGCTGCT|AGTTCGCAGTGATGGATGCCAATCGAGTCC
GCGGTCGCCCGTAATGGCTGACCTTCTAGA|TCCTGGGAAGGATCCTCTGGGTTGATCGAG
TCCCCGGCCTACGACGAAAATTTAGGTAAG|GAGTCCTGGGAAGGATCCTCGGGCTACGAG
ATATATTCTGGATCTTAGAAGTTATGGGTC|CCGATATGGATGCCAATCGAGTCCTGGGAA
GGATGCCAATCGAGTCCTGGGAAGGATCCT|TCGAGTCCTGGGAAGGATCCTGGATGCCAA
AATTCGCATGCTCCGAGCCGTTGCCGCAGG|CCTGGGAAGGATCCAAGGATCCCCTCAGCT
GAAAATTTAGGTAAGCCCACTGCTGGATGC|TCCTCGGGCTACGAGCACTGAGGCTCACCA
TCCGGATGCCAATCGAGTCCTGGGAAGGAT|CCTGGACACCCAACCGATTTGAGTTCGCAG
GAATCCATCGGCCGTGGCTCCGCTAAAGCA|GGATCCTCCAGAGCGGTCGCCCGTAATGGC
CGCCCGTAATGGCTGACCTTCTAGAAAGAG|GGAAGGATCCTCTGGGTTGATCGAGTCGGT
TGGATGCCAATCGAGTCCTGGGAAGGATCC|CCCCGGCCTACGACGAAAATTTAGGTAAGC
ATACCCTCGATTGTAGTCGGGTCGGAGCTT|TGCTTTTAATTCGTTTGCCAGGGGACTATG
AGTCCTGGGAAGGATCCAAGGATCCCCTCA|GATTTGAGTTCGCAGTGATGGATGCCAATC
AGAATTTCAGCTGGCGTCCGGCTGGAGCGA|ATCTTAGAAGTTATGGGTCATCCGAAATAC
GACACCCAACCGATTTGAGTTCGCAGTGAT|AAGGCTTGTCGATCAGGATATGGATGCCAA
GATTGTAGTCGGGTCGGAGCTTGATCATGC|ATTCGTTTGCCAGGGGACTATGTGATACTT
TCTGGGTTGATCGAGTCGGTCCACTCGTTA|CCACTGCTGGATGCCAATCGAGTCCTGGGA
TAGAAAGAGAATTGGTGTCAAGCTTGGAAG|CGAGTCGGTCCACTCGTTATATCGCAATGG
CTCGGGCTACGAGCACTGAGGCTCACCACT|TCTAGTTGCAGGCTTTCTAAGCGTTGAATA
GGAAGGATCCTCTGGGTTGATCGAGTCGGT|TTAGGTAAGCCCACTGCTGGATGCCAATCG
AGCTCCGGATGCTTGTTGCTCAGTGTTCCC|CTGACCTTCTAGAAAGAGAATTGGTGTCAA
GGGGACTATGTGATACTTGGATGCCAATCG|CGAGCCGTTGCCGCAGGCTTGGATGCCAAT
CTGACCTTCTAGAAAGAGAATTGGTGTCAA|TGGGTTGATCGAGTCGGTCCACTCGTTATA
GGAAGGATCCTCGGGCTACGAGCACTGAGG|GCGATGCCTTCTAGTTGCAGGCTTTCTAAG
GAGTCCTGGGAAGGATCCTCTGGGTTGATC|ACGAAAATTTAGGTAAGCCCACTGCTGGAT
AGGCGCGCTGGATGTGGATGCCAATCGAGT|CATAATGAATGGATGCCAATCGAGTCCTGG
CCAAGGATCCCCTCAGCTGCTACCGCCGAA|TGATGGATGCCAATCGAGTCCTGGGAAGGA
TTGAGTTCGCAGTGATGGATGCCAATCGAG|AGGATATGGATGCCAATCGAGTCCTGGGAA
TGCGCAGTATTCGAGGAATCTCTTCTGGAT|GGAAGGATCCGTTGGATGCCAATCGAGTCC
TAGGCGCGCTGGATGTGGATGCCAATCGAG|TCATAATGAATGGATGCCAATCGAGTCCTG
TTTGCCAGGGGACTATGTGATACTTGGATG|CATGCTCCGAGCCGTTGCCGCAGGCTTGGA
TCCCCTCAGCTGCTACCGCCGAATCCATCG|TGCCAATCGAGTCCTGGGAAGGATCCTCCA
ATTAGCACTTCATCCTCGTCCCAGTTCGAT|ATGCCAATCGAGTCCTGGGAAGGATCCCCA
TCAAGCTTGGAAGGCTTGCTCAAAGGCTTG|TATATCGCAATGGTCCCCCACCATTTAACG
ATGCCAATCGAGTCCTGGGAAGGATCCGTA|CCTGGGAAGGATCCGGATGCCAATCGAGTC
ATACCCCTTGGATGCCAATCGAGTCCTGGG|TCTAGAATTATGGGCCAGTGTCCGGGTACT
TGGAGCGATATTAGGTTTGCGGACGTCGTC|CGAAATACCCTCGATTGTAGTCGGGTCGGA
CCAATCGAGTCCTGGGAAGGATCCTCCTAA|ACTGAGCAATCCTTTTCCGAGCACCCACCG
GCAATCCTCTAGTCCTTACGCGAGATGAAT|TCGATGAAGAAAGGTTCGTAATATTTCCCC
AATCGAGTCCTGGGAAGGATCCTGGATGCC|AGGAAATACAAACGTCGAGGGTCCCCGGCC
TCGAGTCCTGGGAAGGATCCAAGGATCCCC|ACCGATTTGAGTTCGCAGTGATGGATGCCA
GACCCCTTCCTTTGACAATACCCCTTGGAT|TAGGTTTGCGGACGTCGTCTAGAATTATGG
CCAGTTCGATGAAGAAAGGTTCGTAATATT|AGGATCCCCAATATGTGACGTGCGCAGTAT
CCTGGGAAGGATCCCCATTATGAGGCGAAT|GGTACTGGCTTTCGCGAGCAATCCTCTAGT
GATGCTTGTTGCTCAGTGTTCCCTCTTCAT|TCTAGAAAGAGAATTGGTGTCAAGCTTGGA
CCGGCCTACGACGAAAATTTAGGTAAGCCC|TCCTGGGAAGGATCCTCGGGCTACGAGCAC
CTGCTACCGCCGAATCCATCGGCCGTGGCT|AGTCCTGGGAAGGATCCTCCAGAGCGGTCG
GCTTGATCATGCCTATTAGCACTTCATCCT|TATGTGATACTTGGATGCCAATCGAGTCCT
GAGTCCTGGGAAGGATCCCCAATATGTGAC|TCGAGTCCTGGTGGATGCCAATCGAGTCCT
CTTTCGCGAGCAATCCTCTAGTCCTTACGC|CGTCCCAGTTCGATGAAGAAAGGTTCGTAA
CCTGGGAAGGATCCGGATGCCAATCGAGTC|TCATGTCGGGTCCTGGACACCCAACCGATT
ATCTTAGAAGTTATGGGTCATCCGAAATAC|GCCAATCGAGTCCTGGGAAGGATCCGTGCT
TGCTCAGTGTTCCCTCTTCATGTCGGGTCC|AGAATTGGTGTCAAGCTTGGAAGGCTTGCT
GATCGAGTCGGTCCACTCGTTATATCGCAA|GGATGCCAATCGAGTCCTGGGAAGGATCCT
CTGGATGCCAATCGAGTCCTGGGAAGGATC|TCCCCGGCCTACGACGAAAATTTAGGTAAG
TCGAGTCCTGGGAAGGATCCGTAATTCGCA|AGGATCCGGATGCCAATCGAGTCCTGGGAA
GAGTCCTGGGAAGGATCCGTTGGATGCCAA|AGCAGCTCCGGATGCTTGTTGCTCAGTGTT
GCTGGATGCCAATCGAGTCCTGGGAAGGAT|GGCTCACCACTGAGCAATCCTTTTCCGAGC
ATTGGTGTCAAGCTTGGAAGGCTTGCTCAA|CACTCGTTATATCGCAATGGTCCCCCACCA
CACTGCTGGATGCCAATCGAGTCCTGGGAA|CTGAGGCTCACCACTGAGCAATCCTTTTCC
CTGGATCTTAGAAGTTATGGGTCATCCGAA|GGATGCCAATCGAGTCCTGGGAAGGATCCG
CTCCAGAGCGGTCGCCCGTAATGGCTGACC|AATCGAGTCCTGGGAAGGATCCTCTGGGTT
AGGATCCCCATTATGAGGCGAATACGGGGG|GCTTTCGCGAGCAATCCTCTAGTCCTTACG
ACGACGAAAATTTAGGTAAGCCCACTGCTG|AAGGATCCTCGGGCTACGAGCACTGAGGCT
AGTCGGGTCGGAGCTTGATCATGCCTATTA|TTGCCAGGGGACTATGTGATACTTGGATGC
CGCGAGCAATCCTCTAGTCCTTACGCGAGA|CCAGTTCGATGAAGAAAGGTTCGTAATATT
GATCCTCCTAAAAACTTAGGCGCGCTGGAT|AGCACCCACCGAGTGGTCATAATGAATGGA
GGTCGGAGCTTGATCATGCCTATTAGCACT|AGGGGACTATGTGATACTTGGATGCCAATC
ATTTGAGTTCGCAGTGATGGATGCCAATCG|TCAGGATATGGATGCCAATCGAGTCCTGGG
GGTCCACTCGTTATATCGCAATGGTCCCCC|TCGAGTCCTGGGAAGGATCCTCCTAAAAAC
AGGGGCGCTCGATAGCCAATTTAACTTGAC|TTCTATGCAGAGAGAATTTCAGCTGGCGTC
GGAAATACAAACGTCGAGGGTCCCCGGCCT|CCTGGGAAGGATCCCCAATCGAGTCCTGGG
CGGAGCTTGATCATGCCTATTAGCACTTCA|GGACTATGTGATACTTGGATGCCAATCGAG
ATGTGACGTGCGCAGTATTCGAGGAATCTC|GAGTCCTGGGAAGGATCCGTTGGATGCCAA
AGGATCCGGATGCCAATCGAGTCCTGGGAA|GGGTCCTGGACACCCAACCGATTTGAGTTC
CGGGGGGACCGAATTCTATGCAGAGAGAAT|CTTACGCGAGATGAATATATTCTGGATCTT
GAGCGATATTAGGTTTGCGGACGTCGTCTA|AAATACCCTCGATTGTAGTCGGGTCGGAGC
TCGTTTGCCAGGGGACTATGTGATACTTGG|TCGCATGCTCCGAGCCGTTGCCGCAGGCTT
TTAATTCGTTTGCCAGGGGACTATGTGATA|GTAATTCGCATGCTCCGAGCCGTTGCCGCA
TGCTCCGAGCCGTTGCCGCAGGCTTGGATG|GGATCCAAGGATCCCCTCAGCTGCTACCGC
TTGTAGTCGGGTCGGAGCTTGATCATGCCT|TCGTTTGCCAGGGGACTATGTGATACTTGG
TAATATTTCCCCGATATGGATGCCAATCGA|GCAGTATTCGAGGAATCTCTTCTGGATGCC
CGCTGTTACGAAGTAAGGCAAGAGGAAATA|CTGGATGTGGATGCCAATCGAGTCCTGGGA
ATCGAGTCCTGGGAAGGATCCGTAATTCGC|AAGGATCCGGATGCCAATCGAGTCCTGGGA
GCAAGAGGAAATACAAACGTCGAGGGTCCC|TCGAGTCCTGGGAAGGATCCCCAATCGAGT
GGATGCCAATCGAGTCCTGGGAAGGATCCA|GGACACCCAACCGATTTGAGTTCGCAGTGA
CTACGACGAAAATTTAGGTAAGCCCACTGC|GGAAGGATCCTCGGGCTACGAGCACTGAGG
TTGCACCGTAAATGAAGGGGCGCTCGATAG|TACGGGGGGACCGAATTCTATGCAGAGAGA
AGAGCGGTCGCCCGTAATGGCTGACCTTCT|GAGTCCTGGGAAGGATCCTCTGGGTTGATC
CGATGAAGAAAGGTTCGTAATATTTCCCCG|CCCAATATGTGACGTGCGCAGTATTCGAGG
TATTAGGTTTGCGGACGTCGTCTAGAATTA|CCTCGATTGTAGTCGGGTCGGAGCTTGATC
GCTCAAAGGCTTGTCGATCAGGATATGGAT|CCACCATTTAACGCTGTTACGAAGTAAGGC
TCGCATGCTCCGAGCCGTTGCCGCAGGCTT|GGGAAGGATCCAAGGATCCCCTCAGCTGCT
GGAAGGATCCTCCTAAAAACTTAGGCGCGC|TTCCGAGCACCCACCGAGTGGTCATAATGA
GATCCGTGCTTTTAATTCGTTTGCCAGGGG|GGGAAGGATCCGTAATTCGCATGCTCCGAG
TAACTTGACGCGAATCTCATGATTGACCCC|GCTGGCGTCCGGCTGGAGCGATATTAGGTT
ATTTAACGCTGTTACGAAGTAAGGCAAGAG|GGCGCGCTGGATGTGGATGCCAATCGAGTC
GAAGAAAGGTTCGTAATATTTCCCCGATAT|ATATGTGACGTGCGCAGTATTCGAGGAATC
GTGACGTGCGCAGTATTCGAGGAATCTCTT|GTCCTGGGAAGGATCCGTTGGATGCCAATC
AGCAGCTCCGGATGCTTGTTGCTCAGTGTT|TGGCTGACCTTCTAGAAAGAGAATTGGTGT
AGTCCTGGGAAGGATCCTCCAGAGCGGTCG|AAGGATCCTGGATGCCAATCGAGTCCTGGG
GTCCGGCTGGAGCGATATTAGGTTTGCGGA|GGTCATCCGAAATACCCTCGATTGTAGTCG
CCTATTAGCACTTCATCCTCGTCCCAGTTC|TGGATGCCAATCGAGTCCTGGGAAGGATCC
GCACTTCATCCTCGTCCCAGTTCGATGAAG|CAATCGAGTCCTGGGAAGGATCCCCAATAT
TCGAGTCCTGGGAAGGATCCTCTGGGTTGA|CGACGAAAATTTAGGTAAGCCCACTGCTGG
GGATCCGTGCTTTTAATTCGTTTGCCAGGG|TGGGAAGGATCCGTAATTCGCATGCTCCGA
CACCCAACCGATTTGAGTTCGCAGTGATGG|GGCTTGTCGATCAGGATATGGATGCCAATC
CTGGGAAGGATCCTCGGGCTACGAGCACTG|TCTGCGATGCCTTCTAGTTGCAGGCTTTCT
CTCAGTGTTCCCTCTTCATGTCGGGTCCTG|AATTGGTGTCAAGCTTGGAAGGCTTGCTCA
TTGGAAGGCTTGCTCAAAGGCTTGTCGATC|GCAATGGTCCCCCACCATTTAACGCTGTTA
GATCCCCAATCGAGTCCTGGGAAGGATCCT|TAGAGCCGTCGCGTGCTCTGCGATGCCTTC
AATCGAGTCCTGGGAAGGATCCTCCTAAAA|TGAGCAATCCTTTTCCGAGCACCCACCGAG
TGTGACGTGCGCAGTATTCGAGGAATCTCT|AGTCCTGGGAAGGATCCGTTGGATGCCAAT
ATCGAGTCCTGGGAAGGATCCGGATGCCAA|TCCCTCTTCATGTCGGGTCCTGGACACCCA
TCCTGGGAAGGATCCCCAATCGAGTCCTGG|GGAAGGATCCTAGAGCCGTCGCGTGCTCTG
CGGCCGTGGCTCCGCTAAAGCAGCTCCGGA|CAGAGCGGTCGCCCGTAATGGCTGACCTTC
GCCGTTGCCGCAGGCTTGGATGCCAATCGA|GGATCCCCTCAGCTGCTACCGCCGAATCCA
CTTGGATGCCAATCGAGTCCTGGTGGATGC|GCTACCGCCGAATCCATCGGCCGTGGCTCC
CGGGTCGGAGCTTGATCATGCCTATTAGCA|CCAGGGGACTATGTGATACTTGGATGCCAA
AGGCTTGGATGCCAATCGAGTCCTGGTGGA|GCTGCTACCGCCGAATCCATCGGCCGTGGC
ATCCTGGATGCCAATCGAGTCCTGGGAAGG|GGGTCCCCGGCCTACGACGAAAATTTAGGT
TTCGAGGAATCTCTTCTGGATGCCAATCGA|CGTTGGATGCCAATCGAGTCCTGGGAAGGA
AGTATTCGAGGAATCTCTTCTGGATGCCAA|GATCCGTTGGATGCCAATCGAGTCCTGGGA
ATCCGTGCTTTTAATTCGTTTGCCAGGGGA|GGAAGGATCCGTAATTCGCATGCTCCGAGC
TAGAAGTTATGGGTCATCCGAAATACCCTC|ATCGAGTCCTGGGAAGGATCCGTGCTTTTA
CGAGTCCTGGGAAGGATCCTCGGGCTACGA|GCGTGCTCTGCGATGCCTTCTAGTTGCAGG
GACGTGCGCAGTATTCGAGGAATCTCTTCT|CCTGGGAAGGATCCGTTGGATGCCAATCGA
TGGTGGATGCCAATCGAGTCCTGGGAAGGA|CCGTGGCTCCGCTAAAGCAGCTCCGGATGC
ATTCTGGATCTTAGAAGTTATGGGTCATCC|TATGGATGCCAATCGAGTCCTGGGAAGGAT
ATTCGAGGAATCTCTTCTGGATGCCAATCG|CCGTTGGATGCCAATCGAGTCCTGGGAAGG
CCGATTTGAGTTCGCAGTGATGGATGCCAA|CGATCAGGATATGGATGCCAATCGAGTCCT
CGCAGGCTTGGATGCCAATCGAGTCCTGGT|TCAGCTGCTACCGCCGAATCCATCGGCCGT
GCCAATCGAGTCCTGGGAAGGATCCTCTGG|GCCTACGACGAAAATTTAGGTAAGCCCACT
TCCTAAAAACTTAGGCGCGCTGGATGTGGA|CCACCGAGTGGTCATAATGAATGGATGCCA
CAATCGAGTCCTGGGAAGGATCCGGATGCC|GTTCCCTCTTCATGTCGGGTCCTGGACACC
CCTCCAGAGCGGTCGCCCGTAATGGCTGAC|CAATCGAGTCCTGGGAAGGATCCTCTGGGT
AAATGAAGGGGCGCTCGATAGCCAATTTAA|ACCGAATTCTATGCAGAGAGAATTTCAGCT
GAGTCCTGGTGGATGCCAATCGAGTCCTGG|CATCGGCCGTGGCTCCGCTAAAGCAGCTCC
CAAGAGGAAATACAAACGTCGAGGGTCCCC|CGAGTCCTGGGAAGGATCCCCAATCGAGTC
CCTTCTAGAAAGAGAATTGGTGTCAAGCTT|TTGATCGAGTCGGTCCACTCGTTATATCGC
CCCCTTGGATGCCAATCGAGTCCTGGGAAG|AGAATTATGGGCCAGTGTCCGGGTACTGGC
GGCCAGTGTCCGGGTACTGGCTTTCGCGAG|GCCTATTAGCACTTCATCCTCGTCCCAGTT
GTCCCCCACCATTTAACGCTGTTACGAAGT|TAAAAACTTAGGCGCGCTGGATGTGGATGC
TACTTGGATGCCAATCGAGTCCTGGGAAGG|CAGGCTTGGATGCCAATCGAGTCCTGGTGG
AAGGCTTGCTCAAAGGCTTGTCGATCAGGA|TGGTCCCCCACCATTTAACGCTGTTACGAA
GGTGTCAAGCTTGGAAGGCTTGCTCAAAGG|TCGTTATATCGCAATGGTCCCCCACCATTT
GTTTGCCAGGGGACTATGTGATACTTGGAT|GCATGCTCCGAGCCGTTGCCGCAGGCTTGG
TACGACGAAAATTTAGGTAAGCCCACTGCT|GAAGGATCCTCGGGCTACGAGCACTGAGGC
GTTGGATGCCAATCGAGTCCTGGGAAGGAT|TTGCTCAGTGTTCCCTCTTCATGTCGGGTC
TCGAGTCGGTCCACTCGTTATATCGCAATG|ATGCCAATCGAGTCCTGGGAAGGATCCTCC
CCAATCGAGTCCTGGGAAGGATCCGTTGGA|CGCTAAAGCAGCTCCGGATGCTTGTTGCTC
GGAAGGATCCGTGCTTTTAATTCGTTTGCC|GTCCTGGGAAGGATCCGTAATTCGCATGCT
GTTGATCGAGTCGGTCCACTCGTTATATCG|GCTGGATGCCAATCGAGTCCTGGGAAGGAT
ATCCTCTGGGTTGATCGAGTCGGTCCACTC|AAGCCCACTGCTGGATGCCAATCGAGTCCT
GCGTCCGGCTGGAGCGATATTAGGTTTGCG|TGGGTCATCCGAAATACCCTCGATTGTAGT
GAAGGATCCGTAATTCGCATGCTCCGAGCC|GCCAATCGAGTCCTGGGAAGGATCCAAGGA
GGCTGGAGCGATATTAGGTTTGCGGACGTC|ATCCGAAATACCCTCGATTGTAGTCGGGTC
GGTAAGCCCACTGCTGGATGCCAATCGAGT|TACGAGCACTGAGGCTCACCACTGAGCAAT
CGAGTCGGTCCACTCGTTATATCGCAATGG|TGCCAATCGAGTCCTGGGAAGGATCCTCCT
AGGATCCGTGCTTTTAATTCGTTTGCCAGG|CTGGGAAGGATCCGTAATTCGCATGCTCCG
AGTGTCCGGGTACTGGCTTTCGCGAGCAAT|ATTAGCACTTCATCCTCGTCCCAGTTCGAT
TCCTTTGACAATACCCCTTGGATGCCAATC|GCGGACGTCGTCTAGAATTATGGGCCAGTG
CTAAAAACTTAGGCGCGCTGGATGTGGATG|ACCGAGTGGTCATAATGAATGGATGCCAAT
ACCTTCTAGAAAGAGAATTGGTGTCAAGCT|GTTGATCGAGTCGGTCCACTCGTTATATCG
AGCACTTCATCCTCGTCCCAGTTCGATGAA|CCAATCGAGTCCTGGGAAGGATCCCCAATA
GTCAAGCTTGGAAGGCTTGCTCAAAGGCTT|TTATATCGCAATGGTCCCCCACCATTTAAC
TGGCTCCGCTAAAGCAGCTCCGGATGCTTG|GGTCGCCCGTAATGGCTGACCTTCTAGAAA
TCGAGTCCTGGGAAGGATCCTGGATGCCAA|GAAATACAAACGTCGAGGGTCCCCGGCCTA
GGATGCTTGTTGCTCAGTGTTCCCTCTTCA|TTCTAGAAAGAGAATTGGTGTCAAGCTTGG
GAGCGGTCGCCCGTAATGGCTGACCTTCTA|AGTCCTGGGAAGGATCCTCTGGGTTGATCG
TGGATGCCAATCGAGTCCTGGGAAGGATCC|ATCGAGTCCTGGGAAGGATCCTGGATGCCA
TTGCTCAAAGGCTTGTCGATCAGGATATGG|CCCCACCATTTAACGCTGTTACGAAGTAAG
TCCGGATGCTTGTTGCTCAGTGTTCCCTCT|ACCTTCTAGAAAGAGAATTGGTGTCAAGCT
AAGCCCACTGCTGGATGCCAATCGAGTCCT|GAGCACTGAGGCTCACCACTGAGCAATCCT
AAGGATCCGTGCTTTTAATTCGTTTGCCAG|CCTGGGAAGGATCCGTAATTCGCATGCTCC
ATTTCAGCTGGCGTCCGGCTGGAGCGATAT|TTAGAAGTTATGGGTCATCCGAAATACCCT
GGATCTTAGAAGTTATGGGTCATCCGAAAT|ATGCCAATCGAGTCCTGGGAAGGATCCGTG
GTCGGTCCACTCGTTATATCGCAATGGTCC|CAATCGAGTCCTGGGAAGGATCCTCCTAAA
GCTCCGGATGCTTGTTGCTCAGTGTTCCCT|TGACCTTCTAGAAAGAGAATTGGTGTCAAG
GATTGACCCCTTCCTTTGACAATACCCCTT|ATATTAGGTTTGCGGACGTCGTCTAGAATT
GAGTCGGTCCACTCGTTATATCGCAATGGT|GCCAATCGAGTCCTGGGAAGGATCCTCCTA
GTGATACTTGGATGCCAATCGAGTCCTGGG|GCCGCAGGCTTGGATGCCAATCGAGTCCTG
CCTGGGAAGGATCCTGGATGCCAATCGAGT|CAAACGTCGAGGGTCCCCGGCCTACGACGA
GAGGGTCCCCGGCCTACGACGAAAATTTAG|CAATCGAGTCCTGGGAAGGATCCTCGGGCT
GTTGCTCAGTGTTCCCTCTTCATGTCGGGT|AGAGAATTGGTGTCAAGCTTGGAAGGCTTG
CCTGGGAAGGATCCCCAATATGTGACGTGC|GTCCTGGTGGATGCCAATCGAGTCCTGGGA
CGCGAATCTCATGATTGACCCCTTCCTTTG|CCGGCTGGAGCGATATTAGGTTTGCGGACG
CTCGTCCCAGTTCGATGAAGAAAGGTTCGT|CTGGGAAGGATCCCCAATATGTGACGTGCG
CCTGGGAAGGATCCGTGCTTTTAATTCGTT|TCGAGTCCTGGGAAGGATCCGTAATTCGCA
TAACGCTGTTACGAAGTAAGGCAAGAGGAA|GCGCTGGATGTGGATGCCAATCGAGTCCTG
ACGTGCGCAGTATTCGAGGAATCTCTTCTG|CTGGGAAGGATCCGTTGGATGCCAATCGAG
TTGCCGCAGGCTTGGATGCCAATCGAGTCC|CCCCTCAGCTGCTACCGCCGAATCCATCGG
AGTCCTGGGAAGGATCCTCTGGGTTGATCG|CGAAAATTTAGGTAAGCCCACTGCTGGATG
GGATGTGGATGCCAATCGAGTCCTGGGAAG|TGGATGCCAATCGAGTCCTGGGAAGGATCC
AACTTGACGCGAATCTCATGATTGACCCCT|CTGGCGTCCGGCTGGAGCGATATTAGGTTT
TCCTGGGAAGGATCCTCCAGAGCGGTCGCC|GGATCCTGGATGCCAATCGAGTCCTGGGAA
GGAAGGATCCCCAATCGAGTCCTGGGAAGG|GATCCTAGAGCCGTCGCGTGCTCTGCGATG
GGGTACTGGCTTTCGCGAGCAATCCTCTAG|CTTCATCCTCGTCCCAGTTCGATGAAGAAA
GTCATCCGAAATACCCTCGATTGTAGTCGG|GAAGGATCCGTGCTTTTAATTCGTTTGCCA
ATCAGGATATGGATGCCAATCGAGTCCTGG|TTACGAAGTAAGGCAAGAGGAAATACAAAC
CCAATCGAGTCCTGGGAAGGATCCGGATGC|TGTTCCCTCTTCATGTCGGGTCCTGGACAC
CGGCTGGAGCGATATTAGGTTTGCGGACGT|CATCCGAAATACCCTCGATTGTAGTCGGGT
AAGTTATGGGTCATCCGAAATACCCTCGAT|GAGTCCTGGGAAGGATCCGTGCTTTTAATT
CTGCTGGATGCCAATCGAGTCCTGGGAAGG|GAGGCTCACCACTGAGCAATCCTTTTCCGA
CGAGTCCTGGGAAGGATCCTCCAGAGCGGT|GGAAGGATCCTGGATGCCAATCGAGTCCTG
ACCCCTTGGATGCCAATCGAGTCCTGGGAA|TAGAATTATGGGCCAGTGTCCGGGTACTGG
GCTTGTTGCTCAGTGTTCCCTCTTCATGTC|AGAAAGAGAATTGGTGTCAAGCTTGGAAGG
TTTCAGCTGGCGTCCGGCTGGAGCGATATT|TAGAAGTTATGGGTCATCCGAAATACCCTC
CCCCACCATTTAACGCTGTTACGAAGTAAG|AAACTTAGGCGCGCTGGATGTGGATGCCAA
CCCTTCCTTTGACAATACCCCTTGGATGCC|GTTTGCGGACGTCGTCTAGAATTATGGGCC
AAGGATCCCCAATATGTGACGTGCGCAGTA|GTGGATGCCAATCGAGTCCTGGGAAGGATC
ACGAAGTAAGGCAAGAGGAAATACAAACGT|TGGATGCCAATCGAGTCCTGGGAAGGATCC
CACTCGTTATATCGCAATGGTCCCCCACCA|GTCCTGGGAAGGATCCTCCTAAAAACTTAG
TACGAAGTAAGGCAAGAGGAAATACAAACG|GTGGATGCCAATCGAGTCCTGGGAAGGATC
TCATCCGAAATACCCTCGATTGTAGTCGGG|AAGGATCCGTGCTTTTAATTCGTTTGCCAG
AGCCGTTGCCGCAGGCTTGGATGCCAATCG|AGGATCCCCTCAGCTGCTACCGCCGAATCC
CAGCTCCGGATGCTTGTTGCTCAGTGTTCC|GCTGACCTTCTAGAAAGAGAATTGGTGTCA
GCCGCAGGCTTGGATGCCAATCGAGTCCTG|CCTCAGCTGCTACCGCCGAATCCATCGGCC
AGAGAGAATTTCAGCTGGCGTCCGGCTGGA|CTGGATCTTAGAAGTTATGGGTCATCCGAA
AATCCATCGGCCGTGGCTCCGCTAAAGCAG|GATCCTCCAGAGCGGTCGCCCGTAATGGCT
GGTCGCCCGTAATGGCTGACCTTCTAGAAA|CTGGGAAGGATCCTCTGGGTTGATCGAGTC
GATGCCAATCGAGTCCTGGGAAGGATCCGT|GCTCCGCTAAAGCAGCTCCGGATGCTTGTT
GAAAGAGAATTGGTGTCAAGCTTGGAAGGC|AGTCGGTCCACTCGTTATATCGCAATGGTC
TAAAAACTTAGGCGCGCTGGATGTGGATGC|CCGAGTGGTCATAATGAATGGATGCCAATC
GAATCTCTTCTGGATGCCAATCGAGTCCTG|ATGCCAATCGAGTCCTGGGAAGGATCCGGA
TAGCCAATTTAACTTGACGCGAATCTCATG|AGAATTTCAGCTGGCGTCCGGCTGGAGCGA
CGAATCCATCGGCCGTGGCTCCGCTAAAGC|AGGATCCTCCAGAGCGGTCGCCCGTAATGG
GCAGTGATGGATGCCAATCGAGTCCTGGGA|GATGCCAATCGAGTCCTGGGAAGGATCCTG
TTCATGTCGGGTCCTGGACACCCAACCGAT|TTGGAAGGCTTGCTCAAAGGCTTGTCGATC
AGTCCTGGTGGATGCCAATCGAGTCCTGGG|ATCGGCCGTGGCTCCGCTAAAGCAGCTCCG
GATGCCAATCGAGTCCTGGGAAGGATCCGT|TCCTGGGAAGGATCCGGATGCCAATCGAGT
TTCCCCGATATGGATGCCAATCGAGTCCTG|TTCGAGGAATCTCTTCTGGATGCCAATCGA
TGGGAAGGATCCGTTGGATGCCAATCGAGT|TCCGGATGCTTGTTGCTCAGTGTTCCCTCT
ATCGCAATGGTCCCCCACCATTTAACGCTG|GGATCCTCCTAAAAACTTAGGCGCGCTGGA
TGCCAATCGAGTCCTGGGAAGGATCCTCCA|AGTCCTGGGAAGGATCCTGGATGCCAATCG
AATTCGTTTGCCAGGGGACTATGTGATACT|AATTCGCATGCTCCGAGCCGTTGCCGCAGG
CCAATCGAGTCCTGGGAAGGATCCTCTGGG|CCTACGACGAAAATTTAGGTAAGCCCACTG
CTGGGAAGGATCCAAGGATCCCCTCAGCTG|TGAGTTCGCAGTGATGGATGCCAATCGAGT
AGTGATGGATGCCAATCGAGTCCTGGGAAG|TGCCAATCGAGTCCTGGGAAGGATCCTGGA
TAAGCCCACTGCTGGATGCCAATCGAGTCC|CGAGCACTGAGGCTCACCACTGAGCAATCC
ATTAGGTTTGCGGACGTCGTCTAGAATTAT|CTCGATTGTAGTCGGGTCGGAGCTTGATCA
AATACCCTCGATTGTAGTCGGGTCGGAGCT|GTGCTTTTAATTCGTTTGCCAGGGGACTAT
GAGTCCTGGGAAGGATCCAAGGATCCCCTC|CGATTTGAGTTCGCAGTGATGGATGCCAAT
CAGAGCGGTCGCCCGTAATGGCTGACCTTC|CGAGTCCTGGGAAGGATCCTCTGGGTTGAT
CTTCATCCTCGTCCCAGTTCGATGAAGAAA|TCGAGTCCTGGGAAGGATCCCCAATATGTG
CTTGGAAGGCTTGCTCAAAGGCTTGTCGAT|CGCAATGGTCCCCCACCATTTAACGCTGTT
TGCAGAGAGAATTTCAGCTGGCGTCCGGCT|ATTCTGGATCTTAGAAGTTATGGGTCATCC
GGCCTACGACGAAAATTTAGGTAAGCCCAC|CTGGGAAGGATCCTCGGGCTACGAGCACTG
CGAGTCCTGGGAAGGATCCCCAATCGAGTC|CCTGGGAAGGATCCTAGAGCCGTCGCGTGC
GTTCGATGAAGAAAGGTTCGTAATATTTCC|ATCCCCAATATGTGACGTGCGCAGTATTCG
CGCATGCTCCGAGCCGTTGCCGCAGGCTTG|GGAAGGATCCAAGGATCCCCTCAGCTGCTA
GCGATATTAGGTTTGCGGACGTCGTCTAGA|ATACCCTCGATTGTAGTCGGGTCGGAGCTT
GAGCAATCCTCTAGTCCTTACGCGAGATGA|GTTCGATGAAGAAAGGTTCGTAATATTTCC
GTCGGAGCTTGATCATGCCTATTAGCACTT|GGGGACTATGTGATACTTGGATGCCAATCG
TGAGTTCGCAGTGATGGATGCCAATCGAGT|GGATATGGATGCCAATCGAGTCCTGGGAAG
CGATATTAGGTTTGCGGACGTCGTCTAGAA|TACCCTCGATTGTAGTCGGGTCGGAGCTTG
ATGCCAATCGAGTCCTGGGAAGGATCCTCC|ACCACTGAGCAATCCTTTTCCGAGCACCCA
GTGGATGCCAATCGAGTCCTGGGAAGGATC|TGCCAATCGAGTCCTGGGAAGGATCCTAGA
ATTGTAGTCGGGTCGGAGCTTGATCATGCC|TTCGTTTGCCAGGGGACTATGTGATACTTG
CAGCTGCTACCGCCGAATCCATCGGCCGTG|TCGAGTCCTGGGAAGGATCCTCCAGAGCGG
CTTTGACAATACCCCTTGGATGCCAATCGA|GGACGTCGTCTAGAATTATGGGCCAGTGTC
GAGTCCTGGGAAGGATCCCCATTATGAGGC|TCCGGGTACTGGCTTTCGCGAGCAATCCTC
AGGCGAATACGGGGGGACCGAATTCTATGC|CCTCTAGTCCTTACGCGAGATGAATATATT
GTCCGGGTACTGGCTTTCGCGAGCAATCCT|AGCACTTCATCCTCGTCCCAGTTCGATGAA
CGAAAATTTAGGTAAGCCCACTGCTGGATG|ATCCTCGGGCTACGAGCACTGAGGCTCACC
CCCCTCAGCTGCTACCGCCGAATCCATCGG|GCCAATCGAGTCCTGGGAAGGATCCTCCAG
TCGGGCTACGAGCACTGAGGCTCACCACTG|CTAGTTGCAGGCTTTCTAAGCGTTGAATAC
GTCCTGGGAAGGATCCAAGGATCCCCTCAG|ATTTGAGTTCGCAGTGATGGATGCCAATCG
CTCTAGTCCTTACGCGAGATGAATATATTC|AAGAAAGGTTCGTAATATTTCCCCGATATG
GCGAATACGGGGGGACCGAATTCTATGCAG|TCTAGTCCTTACGCGAGATGAATATATTCT
CTGGGAAGGATCCGTAATTCGCATGCTCCG|GGATGCCAATCGAGTCCTGGGAAGGATCCA
CAATCGAGTCCTGGGAAGGATCCCCAATCG|GAGTCCTGGGAAGGATCCTAGAGCCGTCGC
TCGAGTCCTGGGAAGGATCCGTGCTTTTAA|TGCCAATCGAGTCCTGGGAAGGATCCGTAA
GATCCTCGGGCTACGAGCACTGAGGCTCAC|GCCTTCTAGTTGCAGGCTTTCTAAGCGTTG
CGCCGAATCCATCGGCCGTGGCTCCGCTAA|GGAAGGATCCTCCAGAGCGGTCGCCCGTAA
TCGAGGAATCTCTTCTGGATGCCAATCGAG|GTTGGATGCCAATCGAGTCCTGGGAAGGAT
AAGTAAGGCAAGAGGAAATACAAACGTCGA|ATGCCAATCGAGTCCTGGGAAGGATCCCCA
GCTCCGAGCCGTTGCCGCAGGCTTGGATGC|GATCCAAGGATCCCCTCAGCTGCTACCGCC
TTCTAGAAAGAGAATTGGTGTCAAGCTTGG|GATCGAGTCGGTCCACTCGTTATATCGCAA
ATCCTCCAGAGCGGTCGCCCGTAATGGCTG|GCCAATCGAGTCCTGGGAAGGATCCTCTGG
GCCAATCGAGTCCTGGGAAGGATCCGTGCT|CTGGATGCCAATCGAGTCCTGGGAAGGATC
GGGAAGGATCCGGATGCCAATCGAGTCCTG|TGTCGGGTCCTGGACACCCAACCGATTTGA
TGCACCGTAAATGAAGGGGCGCTCGATAGC|ACGGGGGGACCGAATTCTATGCAGAGAGAA
TCTCATGATTGACCCCTTCCTTTGACAATA|GGAGCGATATTAGGTTTGCGGACGTCGTCT
TCCTGGGAAGGATCCCCATTATGAGGCGAA|GGGTACTGGCTTTCGCGAGCAATCCTCTAG
TGGATGCCAATCGAGTCCTGGGAAGGATCC|GCTCAGTGTTCCCTCTTCATGTCGGGTCCT
CGAATACGGGGGGACCGAATTCTATGCAGA|CTAGTCCTTACGCGAGATGAATATATTCTG
TAATGGCTGACCTTCTAGAAAGAGAATTGG|ATCCTCTGGGTTGATCGAGTCGGTCCACTC
TAGGTTTGCGGACGTCGTCTAGAATTATGG|CGATTGTAGTCGGGTCGGAGCTTGATCATG
TCCTGGTGGATGCCAATCGAGTCCTGGGAA|CGGCCGTGGCTCCGCTAAAGCAGCTCCGGA
ATTATGAGGCGAATACGGGGGGACCGAATT|AGCAATCCTCTAGTCCTTACGCGAGATGAA
GATCCCCAATATGTGACGTGCGCAGTATTC|GATGCCAATCGAGTCCTGGGAAGGATCCGT
GATGCCAATCGAGTCCTGGGAAGGATCCTG|GGCAAGAGGAAATACAAACGTCGAGGGTCC
AGAGAATTGGTGTCAAGCTTGGAAGGCTTG|CGGTCCACTCGTTATATCGCAATGGTCCCC
GGATCCTGGATGCCAATCGAGTCCTGGGAA|GAGGGTCCCCGGCCTACGACGAAAATTTAG
CCGTTGGATGCCAATCGAGTCCTGGGAAGG|TGTTGCTCAGTGTTCCCTCTTCATGTCGGG
ACGCGAATCTCATGATTGACCCCTTCCTTT|TCCGGCTGGAGCGATATTAGGTTTGCGGAC
TCCTGGGAAGGATCCCCAATATGTGACGTG|AGTCCTGGTGGATGCCAATCGAGTCCTGGG
ATATGGATGCCAATCGAGTCCTGGGAAGGA|AGTAAGGCAAGAGGAAATACAAACGTCGAG
AATCGAGTCCTGGGAAGGATCCTCCAGAGC|CTGGGAAGGATCCTGGATGCCAATCGAGTC
AGGTTTGCGGACGTCGTCTAGAATTATGGG|GATTGTAGTCGGGTCGGAGCTTGATCATGC
GTTATGGGTCATCCGAAATACCCTCGATTG|GTCCTGGGAAGGATCCGTGCTTTTAATTCG
GAAGGATCCTCCTAAAAACTTAGGCGCGCT|TCCGAGCACCCACCGAGTGGTCATAATGAA
TCGGGTCCTGGACACCCAACCGATTTGAGT|GGCTTGCTCAAAGGCTTGTCGATCAGGATA
AATTTAGGTAAGCCCACTGCTGGATGCCAA|TCGGGCTACGAGCACTGAGGCTCACCACTG
CGTAATTCGCATGCTCCGAGCCGTTGCCGC|AGTCCTGGGAAGGATCCAAGGATCCCCTCA
ATGTCGGGTCCTGGACACCCAACCGATTTG|GAAGGCTTGCTCAAAGGCTTGTCGATCAGG
TGGATCTTAGAAGTTATGGGTCATCCGAAA|GATGCCAATCGAGTCCTGGGAAGGATCCGT
ATTATGGGCCAGTGTCCGGGTACTGGCTTT|GATCATGCCTATTAGCACTTCATCCTCGTC
GTAATGGCTGACCTTCTAGAAAGAGAATTG|GATCCTCTGGGTTGATCGAGTCGGTCCACT
TTGACCCCTTCCTTTGACAATACCCCTTGG|ATTAGGTTTGCGGACGTCGTCTAGAATTAT
AGTCCTGGGAAGGATCCCCAATCGAGTCCT|TGGGAAGGATCCTAGAGCCGTCGCGTGCTC
CCGTAATGGCTGACCTTCTAGAAAGAGAAT|AGGATCCTCTGGGTTGATCGAGTCGGTCCA
GGACCGAATTCTATGCAGAGAGAATTTCAG|GCGAGATGAATATATTCTGGATCTTAGAAG
TCCTCCTAAAAACTTAGGCGCGCTGGATGT|CACCCACCGAGTGGTCATAATGAATGGATG
CCTCGGGCTACGAGCACTGAGGCTCACCAC|TTCTAGTTGCAGGCTTTCTAAGCGTTGAAT
CAATCGAGTCCTGGGAAGGATCCGTAATTC|GGAAGGATCCGGATGCCAATCGAGTCCTGG
TAATTCGTTTGCCAGGGGACTATGTGATAC|TAATTCGCATGCTCCGAGCCGTTGCCGCAG
ATCCGTTGGATGCCAATCGAGTCCTGGGAA|CTTGTTGCTCAGTGTTCCCTCTTCATGTCG
CGTGCTTTTAATTCGTTTGCCAGGGGACTA|AGGATCCGTAATTCGCATGCTCCGAGCCGT
CGAGTCCTGGGAAGGATCCAAGGATCCCCT|CCGATTTGAGTTCGCAGTGATGGATGCCAA
CCGAATTCTATGCAGAGAGAATTTCAGCTG|AGATGAATATATTCTGGATCTTAGAAGTTA
GGGAAGGATCCTCCAGAGCGGTCGCCCGTA|CCTGGATGCCAATCGAGTCCTGGGAAGGAT
GAAGGATCCAAGGATCCCCTCAGCTGCTAC|TTCGCAGTGATGGATGCCAATCGAGTCCTG
ACGCTGTTACGAAGTAAGGCAAGAGGAAAT|GCTGGATGTGGATGCCAATCGAGTCCTGGG
CGAGCCGTTGCCGCAGGCTTGGATGCCAAT|CAAGGATCCCCTCAGCTGCTACCGCCGAAT
GGAAGGATCCGTAATTCGCATGCTCCGAGC|TGCCAATCGAGTCCTGGGAAGGATCCAAGG
GCAGCTCCGGATGCTTGTTGCTCAGTGTTC|GGCTGACCTTCTAGAAAGAGAATTGGTGTC
AAATACAAACGTCGAGGGTCCCCGGCCTAC|TGGGAAGGATCCCCAATCGAGTCCTGGGAA
CTATTAGCACTTCATCCTCGTCCCAGTTCG|GGATGCCAATCGAGTCCTGGGAAGGATCCC
AATTTAACTTGACGCGAATCTCATGATTGA|TTCAGCTGGCGTCCGGCTGGAGCGATATTA
TCTTCATGTCGGGTCCTGGACACCCAACCG|GCTTGGAAGGCTTGCTCAAAGGCTTGTCGA
AATATATTCTGGATCTTAGAAGTTATGGGT|CCCGATATGGATGCCAATCGAGTCCTGGGA
ATACGGGGGGACCGAATTCTATGCAGAGAG|GTCCTTACGCGAGATGAATATATTCTGGAT
GCTTGGATGCCAATCGAGTCCTGGTGGATG|TGCTACCGCCGAATCCATCGGCCGTGGCTC
AATTTCAGCTGGCGTCCGGCTGGAGCGATA|CTTAGAAGTTATGGGTCATCCGAAATACCC
CGCAATGGTCCCCCACCATTTAACGCTGTT|ATCCTCCTAAAAACTTAGGCGCGCTGGATG
CCGGATGCCAATCGAGTCCTGGGAAGGATC|CTGGACACCCAACCGATTTGAGTTCGCAGT
ATATGGATGCCAATCGAGTCCTGGGAAGGA|AATCTCTTCTGGATGCCAATCGAGTCCTGG
GAATTATGGGCCAGTGTCCGGGTACTGGCT|TTGATCATGCCTATTAGCACTTCATCCTCG
GAAGGATCCGGATGCCAATCGAGTCCTGGG|TCGGGTCCTGGACACCCAACCGATTTGAGT
CTCCGCTAAAGCAGCTCCGGATGCTTGTTG|CGCCCGTAATGGCTGACCTTCTAGAAAGAG
AGGATCCCCTCAGCTGCTACCGCCGAATCC|TGGATGCCAATCGAGTCCTGGGAAGGATCC
GGATGCCAATCGAGTCCTGGTGGATGCCAA|ACCGCCGAATCCATCGGCCGTGGCTCCGCT
GGGCCAGTGTCCGGGTACTGGCTTTCGCGA|TGCCTATTAGCACTTCATCCTCGTCCCAGT
GTGCGCAGTATTCGAGGAATCTCTTCTGGA|GGGAAGGATCCGTTGGATGCCAATCGAGTC
AGGATCCTGGATGCCAATCGAGTCCTGGGA|CGAGGGTCCCCGGCCTACGACGAAAATTTA
ATGCCAATCGAGTCCTGGGAAGGATCCTCC|GAGTCCTGGGAAGGATCCTGGATGCCAATC
CTTGACGCGAATCTCATGATTGACCCCTTC|GGCGTCCGGCTGGAGCGATATTAGGTTTGC
AGCGATATTAGGTTTGCGGACGTCGTCTAG|AATACCCTCGATTGTAGTCGGGTCGGAGCT
AAACTTAGGCGCGCTGGATGTGGATGCCAA|AGTGGTCATAATGAATGGATGCCAATCGAG
AAAGCAGCTCCGGATGCTTGTTGCTCAGTG|AATGGCTGACCTTCTAGAAAGAGAATTGGT
TCCAAGGATCCCCTCAGCTGCTACCGCCGA|GTGATGGATGCCAATCGAGTCCTGGGAAGG
TCGAGTCCTGGTGGATGCCAATCGAGTCCT|TCCATCGGCCGTGGCTCCGCTAAAGCAGCT
CCTAAAAACTTAGGCGCGCTGGATGTGGAT|CACCGAGTGGTCATAATGAATGGATGCCAA
CCCCAATATGTGACGTGCGCAGTATTCGAG|GCCAATCGAGTCCTGGGAAGGATCCGTTGG
AAAACTTAGGCGCGCTGGATGTGGATGCCA|GAGTGGTCATAATGAATGGATGCCAATCGA
ATCGAGTCCTGGGAAGGATCCCCAATATGT|CAATCGAGTCCTGGTGGATGCCAATCGAGT
CTGGTGGATGCCAATCGAGTCCTGGGAAGG|GCCGTGGCTCCGCTAAAGCAGCTCCGGATG
TTCTGGATGCCAATCGAGTCCTGGGAAGGA|TCGAGTCCTGGGAAGGATCCGGATGCCAAT
GCTGCTACCGCCGAATCCATCGGCCGTGGC|GAGTCCTGGGAAGGATCCTCCAGAGCGGTC
GGACTATGTGATACTTGGATGCCAATCGAG|AGCCGTTGCCGCAGGCTTGGATGCCAATCG
TATGGATGCCAATCGAGTCCTGGGAAGGAT|GTAAGGCAAGAGGAAATACAAACGTCGAGG
AAACGTCGAGGGTCCCCGGCCTACGACGAA|GGATCCCCAATCGAGTCCTGGGAAGGATCC
GCTCCGCTAAAGCAGCTCCGGATGCTTGTT|TCGCCCGTAATGGCTGACCTTCTAGAAAGA
ATCCCCTCAGCTGCTACCGCCGAATCCATC|ATGCCAATCGAGTCCTGGGAAGGATCCTCC
CCGAGCCGTTGCCGCAGGCTTGGATGCCAA|CCAAGGATCCCCTCAGCTGCTACCGCCGAA
GATCCCCATTATGAGGCGAATACGGGGGGA|TTTCGCGAGCAATCCTCTAGTCCTTACGCG
GTGGATGCCAATCGAGTCCTGGGAAGGATC|GTGGCTCCGCTAAAGCAGCTCCGGATGCTT
GGGAAGGATCCGTGCTTTTAATTCGTTTGC|AGTCCTGGGAAGGATCCGTAATTCGCATGC
TCGAGTCCTGGGAAGGATCCTCGGGCTACG|CGCGTGCTCTGCGATGCCTTCTAGTTGCAG
ATGTGGATGCCAATCGAGTCCTGGGAAGGA|GATGCCAATCGAGTCCTGGGAAGGATCCTA
GAGGAATCTCTTCTGGATGCCAATCGAGTC|TGGATGCCAATCGAGTCCTGGGAAGGATCC
GTCCCAGTTCGATGAAGAAAGGTTCGTAAT|GGAAGGATCCCCAATATGTGACGTGCGCAG
CCCTCTTCATGTCGGGTCCTGGACACCCAA|CAAGCTTGGAAGGCTTGCTCAAAGGCTTGT
CTGGACACCCAACCGATTTGAGTTCGCAGT|TCAAAGGCTTGTCGATCAGGATATGGATGC
GGATCCTCTGGGTTGATCGAGTCGGTCCAC|GTAAGCCCACTGCTGGATGCCAATCGAGTC
AGCTGCTACCGCCGAATCCATCGGCCGTGG|CGAGTCCTGGGAAGGATCCTCCAGAGCGGT
TATGTGACGTGCGCAGTATTCGAGGAATCT|CGAGTCCTGGGAAGGATCCGTTGGATGCCA
GGATCCCCTCAGCTGCTACCGCCGAATCCA|GGATGCCAATCGAGTCCTGGGAAGGATCCT
ACCGTAAATGAAGGGGCGCTCGATAGCCAA|GGGGGACCGAATTCTATGCAGAGAGAATTT
CCTGGATGCCAATCGAGTCCTGGGAAGGAT|GTCCCCGGCCTACGACGAAAATTTAGGTAA
CTGGGTTGATCGAGTCGGTCCACTCGTTAT|CACTGCTGGATGCCAATCGAGTCCTGGGAA
CCTTACGCGAGATGAATATATTCTGGATCT|GTTCGTAATATTTCCCCGATATGGATGCCA
CTGGGAAGGATCCTGGATGCCAATCGAGTC|AAACGTCGAGGGTCCCCGGCCTACGACGAA
CGAATTCTATGCAGAGAGAATTTCAGCTGG|GATGAATATATTCTGGATCTTAGAAGTTAT
TACCGCCGAATCCATCGGCCGTGGCTCCGC|CTGGGAAGGATCCTCCAGAGCGGTCGCCCG
TGTGATACTTGGATGCCAATCGAGTCCTGG|TGCCGCAGGCTTGGATGCCAATCGAGTCCT
GTCTAGAATTATGGGCCAGTGTCCGGGTAC|GGAGCTTGATCATGCCTATTAGCACTTCAT
ATGCCAATCGAGTCCTGGGAAGGATCCAAG|ACACCCAACCGATTTGAGTTCGCAGTGATG
AACGCTGTTACGAAGTAAGGCAAGAGGAAA|CGCTGGATGTGGATGCCAATCGAGTCCTGG
AATGAAGGGGCGCTCGATAGCCAATTTAAC|CCGAATTCTATGCAGAGAGAATTTCAGCTG
GGGTCGGAGCTTGATCATGCCTATTAGCAC|CAGGGGACTATGTGATACTTGGATGCCAAT
GATTTGAGTTCGCAGTGATGGATGCCAATC|ATCAGGATATGGATGCCAATCGAGTCCTGG
AATACGGGGGGACCGAATTCTATGCAGAGA|AGTCCTTACGCGAGATGAATATATTCTGGA
CTGGAGCGATATTAGGTTTGCGGACGTCGT|CCGAAATACCCTCGATTGTAGTCGGGTCGG
GGATCCTCCTAAAAACTTAGGCGCGCTGGA|GAGCACCCACCGAGTGGTCATAATGAATGG
GAAGGATCCCCATTATGAGGCGAATACGGG|TGGCTTTCGCGAGCAATCCTCTAGTCCTTA
AGGGGACTATGTGATACTTGGATGCCAATC|CCGAGCCGTTGCCGCAGGCTTGGATGCCAA
TTTGACAATACCCCTTGGATGCCAATCGAG|GACGTCGTCTAGAATTATGGGCCAGTGTCC
CGTAATGGCTGACCTTCTAGAAAGAGAATT|GGATCCTCTGGGTTGATCGAGTCGGTCCAC
CCCCAATCGAGTCCTGGGAAGGATCCTCGG|AGCCGTCGCGTGCTCTGCGATGCCTTCTAG
GTGTCCGGGTACTGGCTTTCGCGAGCAATC|TTAGCACTTCATCCTCGTCCCAGTTCGATG
ACCGCCGAATCCATCGGCCGTGGCTCCGCT|TGGGAAGGATCCTCCAGAGCGGTCGCCCGT
TCGATAGCCAATTTAACTTGACGCGAATCT|AGAGAGAATTTCAGCTGGCGTCCGGCTGGA
GGAAGGATCCGTTGGATGCCAATCGAGTCC|CGGATGCTTGTTGCTCAGTGTTCCCTCTTC
GAAGTAAGGCAAGAGGAAATACAAACGTCG|GATGCCAATCGAGTCCTGGGAAGGATCCCC
TGCCAATCGAGTCCTGGTGGATGCCAATCG|GCCGAATCCATCGGCCGTGGCTCCGCTAAA
CAAAGGCTTGTCGATCAGGATATGGATGCC|CCATTTAACGCTGTTACGAAGTAAGGCAAG
CCTCGTCCCAGTTCGATGAAGAAAGGTTCG|CCTGGGAAGGATCCCCAATATGTGACGTGC
GGGAAGGATCCGTTGGATGCCAATCGAGTC|CCGGATGCTTGTTGCTCAGTGTTCCCTCTT
TCGAGTCCTGGGAAGGATCCCCAATATGTG|AATCGAGTCCTGGTGGATGCCAATCGAGTC
CATCCTCGTCCCAGTTCGATGAAGAAAGGT|AGTCCTGGGAAGGATCCCCAATATGTGACG
GAAGGCTTGCTCAAAGGCTTGTCGATCAGG|ATGGTCCCCCACCATTTAACGCTGTTACGA
TGAAGAAAGGTTCGTAATATTTCCCCGATA|AATATGTGACGTGCGCAGTATTCGAGGAAT
ATCCGTAATTCGCATGCTCCGAGCCGTTGC|TCGAGTCCTGGGAAGGATCCAAGGATCCCC
TCCGTGCTTTTAATTCGTTTGCCAGGGGAC|GAAGGATCCGTAATTCGCATGCTCCGAGCC
TGGGAAGGATCCGTAATTCGCATGCTCCGA|GATGCCAATCGAGTCCTGGGAAGGATCCAA
AATCGAGTCCTGGGAAGGATCCCCATTATG|AGTGTCCGGGTACTGGCTTTCGCGAGCAAT
GCCAATCGAGTCCTGGGAAGGATCCTCCAG|GTCCTGGGAAGGATCCTGGATGCCAATCGA
TGACCTTCTAGAAAGAGAATTGGTGTCAAG|GGGTTGATCGAGTCGGTCCACTCGTTATAT
GAGCCGTTGCCGCAGGCTTGGATGCCAATC|AAGGATCCCCTCAGCTGCTACCGCCGAATC
CCCATTATGAGGCGAATACGGGGGGACCGA|GCGAGCAATCCTCTAGTCCTTACGCGAGAT
GTCGCCCGTAATGGCTGACCTTCTAGAAAG|TGGGAAGGATCCTCTGGGTTGATCGAGTCG
ATCGAGTCCTGGGAAGGATCCAAGGATCCC|AACCGATTTGAGTTCGCAGTGATGGATGCC
CCCCTTCCTTTGACAATACCCCTTGGATGC|GGTTTGCGGACGTCGTCTAGAATTATGGGC
GGCGCTCGATAGCCAATTTAACTTGACGCG|TATGCAGAGAGAATTTCAGCTGGCGTCCGG
GATCCAAGGATCCCCTCAGCTGCTACCGCC|CAGTGATGGATGCCAATCGAGTCCTGGGAA
CGATTTGAGTTCGCAGTGATGGATGCCAAT|GATCAGGATATGGATGCCAATCGAGTCCTG
GATCTTAGAAGTTATGGGTCATCCGAAATA|TGCCAATCGAGTCCTGGGAAGGATCCGTGC
GCTGGAGCGATATTAGGTTTGCGGACGTCG|TCCGAAATACCCTCGATTGTAGTCGGGTCG
CCCCCACCATTTAACGCTGTTACGAAGTAA|AAAACTTAGGCGCGCTGGATGTGGATGCCA
ATTCTATGCAGAGAGAATTTCAGCTGGCGT|GAATATATTCTGGATCTTAGAAGTTATGGG
GCTACCGCCGAATCCATCGGCCGTGGCTCC|TCCTGGGAAGGATCCTCCAGAGCGGTCGCC
TCCTCTAGTCCTTACGCGAGATGAATATAT|TGAAGAAAGGTTCGTAATATTTCCCCGATA
TGGGAAGGATCCTGGATGCCAATCGAGTCC|AACGTCGAGGGTCCCCGGCCTACGACGAAA
CTGGCGTCCGGCTGGAGCGATATTAGGTTT|TTATGGGTCATCCGAAATACCCTCGATTGT
CCAACCGATTTGAGTTCGCAGTGATGGATG|TTGTCGATCAGGATATGGATGCCAATCGAG
CCGCTAAAGCAGCTCCGGATGCTTGTTGCT|CCCGTAATGGCTGACCTTCTAGAAAGAGAA
CTTAGGCGCGCTGGATGTGGATGCCAATCG|GGTCATAATGAATGGATGCCAATCGAGTCC
TGGATGCCAATCGAGTCCTGGGAAGGATCC|TATGGGCCAGTGTCCGGGTACTGGCTTTCG
TTGATCATGCCTATTAGCACTTCATCCTCG|TGTGATACTTGGATGCCAATCGAGTCCTGG
GGCCGTGGCTCCGCTAAAGCAGCTCCGGAT|AGAGCGGTCGCCCGTAATGGCTGACCTTCT
GGAAGGATCCTCCAGAGCGGTCGCCCGTAA|CTGGATGCCAATCGAGTCCTGGGAAGGATC
TACAAACGTCGAGGGTCCCCGGCCTACGAC|GAAGGATCCCCAATCGAGTCCTGGGAAGGA
ATATTAGGTTTGCGGACGTCGTCTAGAATT|CCCTCGATTGTAGTCGGGTCGGAGCTTGAT
TTTTAATTCGTTTGCCAGGGGACTATGTGA|CCGTAATTCGCATGCTCCGAGCCGTTGCCG
TTGTTGCTCAGTGTTCCCTCTTCATGTCGG|AAAGAGAATTGGTGTCAAGCTTGGAAGGCT
AGCGGTCGCCCGTAATGGCTGACCTTCTAG|GTCCTGGGAAGGATCCTCTGGGTTGATCGA
GATGCCAATCGAGTCCTGGGAAGGATCCTC|CACCACTGAGCAATCCTTTTCCGAGCACCC
TGCCAATCGAGTCCTGGGAAGGATCCAAGG|CACCCAACCGATTTGAGTTCGCAGTGATGG
TCTAGTCCTTACGCGAGATGAATATATTCT|AGAAAGGTTCGTAATATTTCCCCGATATGG
CTGGGAAGGATCCGTGCTTTTAATTCGTTT|CGAGTCCTGGGAAGGATCCGTAATTCGCAT
GGATCCTCCAGAGCGGTCGCCCGTAATGGC|ATGCCAATCGAGTCCTGGGAAGGATCCTCT
TCCAGAGCGGTCGCCCGTAATGGCTGACCT|ATCGAGTCCTGGGAAGGATCCTCTGGGTTG
GATGGATGCCAATCGAGTCCTGGGAAGGAT|CAATCGAGTCCTGGGAAGGATCCTGGATGC
TGACAATACCCCTTGGATGCCAATCGAGTC|CGTCGTCTAGAATTATGGGCCAGTGTCCGG
ATCGAGTCGGTCCACTCGTTATATCGCAAT|GATGCCAATCGAGTCCTGGGAAGGATCCTC
TGCCAGGGGACTATGTGATACTTGGATGCC|TGCTCCGAGCCGTTGCCGCAGGCTTGGATG
GGTGGATGCCAATCGAGTCCTGGGAAGGAT|CGTGGCTCCGCTAAAGCAGCTCCGGATGCT
CCGATATGGATGCCAATCGAGTCCTGGGAA|AGGAATCTCTTCTGGATGCCAATCGAGTCC
GATCCCCTCAGCTGCTACCGCCGAATCCAT|GATGCCAATCGAGTCCTGGGAAGGATCCTC
AGTCCTGGGAAGGATCCGTAATTCGCATGC|ATCCGGATGCCAATCGAGTCCTGGGAAGGA
GGAAGGATCCCCATTATGAGGCGAATACGG|CTGGCTTTCGCGAGCAATCCTCTAGTCCTT
GGATGCCAATCGAGTCCTGGGAAGGATCCG|TCTTCTGGATGCCAATCGAGTCCTGGGAAG
TTCATCCTCGTCCCAGTTCGATGAAGAAAG|CGAGTCCTGGGAAGGATCCCCAATATGTGA
GTTGCCGCAGGCTTGGATGCCAATCGAGTC|TCCCCTCAGCTGCTACCGCCGAATCCATCG
TTTGAGTTCGCAGTGATGGATGCCAATCGA|CAGGATATGGATGCCAATCGAGTCCTGGGA
CCCGTAATGGCTGACCTTCTAGAAAGAGAA|AAGGATCCTCTGGGTTGATCGAGTCGGTCC
GATGTGGATGCCAATCGAGTCCTGGGAAGG|GGATGCCAATCGAGTCCTGGGAAGGATCCT
TCCCCGATATGGATGCCAATCGAGTCCTGG|TCGAGGAATCTCTTCTGGATGCCAATCGAG
TTATGGGCCAGTGTCCGGGTACTGGCTTTC|ATCATGCCTATTAGCACTTCATCCTCGTCC
CCAGAGCGGTCGCCCGTAATGGCTGACCTT|TCGAGTCCTGGGAAGGATCCTCTGGGTTGA
TCGGAGCTTGATCATGCCTATTAGCACTTC|GGGACTATGTGATACTTGGATGCCAATCGA
GGATCCCCATTATGAGGCGAATACGGGGGG|CTTTCGCGAGCAATCCTCTAGTCCTTACGC
CCTGGGAAGGATCCTCTGGGTTGATCGAGT|AAATTTAGGTAAGCCCACTGCTGGATGCCA
TCCGTTGGATGCCAATCGAGTCCTGGGAAG|TTGTTGCTCAGTGTTCCCTCTTCATGTCGG
TGGTCCCCCACCATTTAACGCTGTTACGAA|CCTAAAAACTTAGGCGCGCTGGATGTGGAT
TGATACTTGGATGCCAATCGAGTCCTGGGA|CCGCAGGCTTGGATGCCAATCGAGTCCTGG
TCCTCGGGCTACGAGCACTGAGGCTCACCA|CTTCTAGTTGCAGGCTTTCTAAGCGTTGAA
CAAGCTTGGAAGGCTTGCTCAAAGGCTTGT|ATATCGCAATGGTCCCCCACCATTTAACGC
GAGGAAATACAAACGTCGAGGGTCCCCGGC|GTCCTGGGAAGGATCCCCAATCGAGTCCTG
GCCAGTGTCCGGGTACTGGCTTTCGCGAGC|CCTATTAGCACTTCATCCTCGTCCCAGTTC
CGCAGTATTCGAGGAATCTCTTCTGGATGC|AAGGATCCGTTGGATGCCAATCGAGTCCTG
TTAGGTTTGCGGACGTCGTCTAGAATTATG|TCGATTGTAGTCGGGTCGGAGCTTGATCAT
GGGAAGGATCCTCTGGGTTGATCGAGTCGG|TTTAGGTAAGCCCACTGCTGGATGCCAATC
CTTCATGTCGGGTCCTGGACACCCAACCGA|CTTGGAAGGCTTGCTCAAAGGCTTGTCGAT
AAGGATCCTGGATGCCAATCGAGTCCTGGG|TCGAGGGTCCCCGGCCTACGACGAAAATTT
CAGTGTTCCCTCTTCATGTCGGGTCCTGGA|TTGGTGTCAAGCTTGGAAGGCTTGCTCAAA
CCCTCAGCTGCTACCGCCGAATCCATCGGC|CCAATCGAGTCCTGGGAAGGATCCTCCAGA
GACGCGAATCTCATGATTGACCCCTTCCTT|GTCCGGCTGGAGCGATATTAGGTTTGCGGA
AAGGCAAGAGGAAATACAAACGTCGAGGGT|CAATCGAGTCCTGGGAAGGATCCCCAATCG
AACTTAGGCGCGCTGGATGTGGATGCCAAT|GTGGTCATAATGAATGGATGCCAATCGAGT
